"Date","Open","High","Low","Close","Adj.Close","Volume","sma","pricevolatility"
"2016-01-04",147500,148000,143500,144000,109247.6875,445332,NA,4500
"2016-01-05",143000,145000,142000,143500,108868.375,530496,NA,3000
"2016-01-06",144000,145000,139000,140000,106213.03125,769406,NA,6000
"2016-01-07",138500,140000,137500,137500,104316.390625,586187,NA,2500
"2016-01-08",134500,138000,133500,136500,103557.71875,888701,NA,4500
"2016-01-11",134500,140500,134000,140000,106213.03125,542749,NA,6500
"2016-01-12",140500,141500,139000,139500,105833.703125,386506,NA,2500
"2016-01-13",140500,141500,139500,140500,106592.359375,338336,NA,2000
"2016-01-14",138500,143500,136500,141000,106971.703125,664829,NA,7000
"2016-01-15",141000,142000,136500,138500,105075.046875,568653,NA,5500
"2016-01-18",137500,140000,135500,139000,105454.3671875,400716,NA,4500
"2016-01-19",138000,140000,136000,140000,106213.03125,332956,NA,4000
"2016-01-20",139500,140000,135500,136500,103557.71875,544330,NA,4500
"2016-01-21",136000,138000,135500,137000,103937.046875,455723,NA,2500
"2016-01-22",138000,140500,136500,139000,105454.3671875,551671,NA,4000
"2016-01-25",140000,140500,136000,137500,104316.390625,543064,NA,4500
"2016-01-26",136500,137000,134500,136000,103178.3671875,564584,NA,2500
"2016-01-27",135500,137000,134500,137000,103937.046875,702981,NA,2500
"2016-01-28",135500,136500,134500,135000,102419.7109375,480730,NA,2000
"2016-01-29",135000,136000,131000,133000,100902.390625,990382,138550,5000
"2016-02-01",132000,132500,130500,132500,100523.0390625,689972,137975,2000
"2016-02-02",131500,132500,129000,129500,98247.0625,594441,137275,3500
"2016-02-03",127500,129500,126500,129000,97867.734375,649021,136725,3000
"2016-02-04",130000,132500,129500,132500,100523.0390625,600523,136475,3000
"2016-02-05",132000,133500,131000,133500,101281.7265625,513150,136325,2500
"2016-02-11",130500,132500,130500,131000,99385.046875,688873,135875,2000
"2016-02-12",131500,137500,131000,137000,103937.046875,1264899,135750,6500
"2016-02-15",137500,141500,135000,139500,105833.703125,879160,135700,6500
"2016-02-16",139500,142500,137500,141000,106971.703125,524822,135700,5000
"2016-02-17",142000,147500,141000,147000,111523.6796875,772996,136125,6500
"2016-02-18",147500,149000,145500,147000,111523.6796875,468798,136525,3500
"2016-02-19",147000,151000,147000,149000,113041.03125,477553,136975,4000
"2016-02-22",147500,148500,146000,147500,111903.0078125,273335,137525,2500
"2016-02-23",148000,149000,146500,149000,113041.03125,250401,138125,2500
"2016-02-24",147500,150000,146500,149000,113041.03125,191286,138625,3500
"2016-02-25",149500,153000,145500,147000,111523.6796875,490265,139100,7500
"2016-02-26",148000,148000,144500,147000,111523.6796875,351408,139650,3500
"2016-02-29",145500,149000,144500,147500,111903.0078125,570117,140175,4500
"2016-03-02",150000,150000,148000,150000,113799.6796875,539821,140925,2000
"2016-03-03",151500,151500,146000,147500,111903.0078125,627810,141650,5500
"2016-03-04",146000,147500,143500,147500,111903.0078125,696287,142400,4000
"2016-03-07",147500,147500,145500,146500,111144.3515625,317439,143250,2000
"2016-03-08",145000,149500,145000,148000,112282.3359375,366489,144200,4500
"2016-03-09",147000,149500,146500,149500,113420.3515625,452965,145050,3000
"2016-03-10",149000,150000,148000,148000,112282.3359375,690061,145775,2000
"2016-03-11",147500,150000,147500,149000,113041.03125,408175,146675,2500
"2016-03-14",150000,150500,147000,148500,112661.671875,362075,147250,3500
"2016-03-15",148500,149000,146000,147000,111523.6796875,309077,147625,3000
"2016-03-16",147000,148000,145500,146500,111144.3515625,206136,147900,2500
"2016-03-17",148000,148500,146000,146500,111144.3515625,492380,147875,2500
"2016-03-18",148000,150500,147500,150500,114178.984375,769047,148050,3000
"2016-03-21",151000,155000,149500,154500,117213.65625,803657,148325,5500
"2016-03-22",155500,159000,155000,159000,120627.640625,872121,148900,4000
"2016-03-23",159500,159500,157000,158000,119868.96875,454762,149350,2500
"2016-03-24",156500,157000,154500,155500,117972.328125,288522,149675,2500
"2016-03-25",154500,155500,152000,153000,116075.6640625,279961,149975,3500
"2016-03-28",153000,156500,152000,154000,116834.3203125,186865,150325,4500
"2016-03-29",155000,156000,153500,155000,117592.9921875,229075,150700,2500
"2016-03-30",156000,159000,155000,155500,117972.328125,373060,150975,4000
"2016-03-31",156000,156000,151500,152500,115696.3125,575626,151225,4500
"2016-04-01",152500,152500,147500,149500,113420.3515625,604435,151325,5000
"2016-04-04",148500,149500,143500,144000,109247.6875,767267,151200,6000
"2016-04-05",144000,145000,143500,144500,109627.0234375,292339,151025,1500
"2016-04-06",144000,146000,144000,144000,109247.6875,379789,150750,2000
"2016-04-07",143500,146500,143500,146500,111144.3515625,366852,150675,3000
"2016-04-08",146000,146500,144000,146000,110765.0234375,339546,150525,2500
"2016-04-11",147500,147500,145000,146000,110765.0234375,197423,150400,2500
"2016-04-12",146000,150000,145000,148500,112661.671875,361212,150475,5000
"2016-04-14",150000,152000,149500,152000,115317.015625,496852,150750,2500
"2016-04-15",150500,152000,149000,151500,114937.6796875,297722,151000,3000
"2016-04-18",150000,155000,150000,154000,116834.3203125,406339,151175,5000
"2016-04-19",155000,155000,152000,153000,116075.6640625,310407,151100,3000
"2016-04-20",153500,155000,151000,151500,114937.6796875,270230,150725,4000
"2016-04-21",152000,154500,152000,154000,116834.3203125,297646,150525,2500
"2016-04-22",152000,153500,150500,151000,114558.3359375,318972,150300,3000
"2016-04-25",151000,152000,149000,149500,113420.3515625,273343,150125,3000
"2016-04-26",149000,154000,149000,153500,116454.984375,365930,150100,5000
"2016-04-27",152000,153000,148500,149000,113041.03125,374037,149800,4500
"2016-04-28",148500,150500,147000,148000,112282.3359375,466520,149425,3500
"2016-04-29",146500,147500,142000,143500,108868.375,739237,148975,5500
"2016-05-02",142000,144000,141500,142500,108109.703125,242036,148625,2500
"2016-05-03",143000,144000,142000,142500,108109.703125,359029,148550,2000
"2016-05-04",141500,142000,138500,139000,105454.3671875,807340,148275,3500
"2016-05-09",138500,139000,135500,135500,102799.0390625,482711,147850,3500
"2016-05-10",136500,140500,136500,139500,105833.703125,346710,147500,4000
"2016-05-11",140500,142000,138500,139000,105454.3671875,284228,147150,3500
"2016-05-12",138000,138500,136500,136500,103557.71875,421047,146675,2000
"2016-05-13",136000,137500,135000,135000,102419.7109375,529746,146000,2500
"2016-05-16",136500,137500,135000,135500,102799.0390625,397771,145175,2500
"2016-05-17",135500,136500,134500,134500,102040.3828125,314839,144325,2000
"2016-05-18",135000,135500,132000,133000,100902.390625,630692,143275,3500
"2016-05-19",132500,136000,132500,134500,102040.3828125,389055,142350,3500
"2016-05-20",134000,135000,131500,132000,100143.7109375,462176,141375,3500
"2016-05-23",133000,134500,133000,133000,100902.390625,310458,140325,1500
"2016-05-24",133000,135000,132000,133500,101281.7265625,355717,139450,3000
"2016-05-25",134500,137000,134000,135000,102419.7109375,500528,138725,3000
"2016-05-26",136000,137000,134500,135000,102419.7109375,342299,137800,2500
"2016-05-27",136000,136500,135000,136000,103178.3671875,346406,137150,1500
"2016-05-30",136000,137500,135000,136500,103557.71875,474129,136575,2500
"2016-05-31",136500,139500,135000,139500,105833.703125,1734508,136375,4500
"2016-06-01",137500,138500,136500,138000,104695.7109375,507997,136150,2000
"2016-06-02",138500,139000,136500,138000,104695.7109375,419054,135925,2500
"2016-06-03",138000,139500,137500,138500,105075.046875,352778,135900,2000
"2016-06-07",138500,139500,137500,139500,105833.703125,608452,136100,2000
"2016-06-08",138500,141500,138500,139500,105833.703125,598656,136100,3000
"2016-06-09",139500,140500,137500,139000,105454.3671875,578177,136100,3000
"2016-06-10",138500,140000,138000,139000,105454.3671875,350588,136225,2000
"2016-06-13",138000,138500,135500,135500,102799.0390625,476958,136250,3000
"2016-06-14",135500,138500,135000,138500,105075.046875,431039,136400,3500
"2016-06-15",138000,139500,135000,135500,102799.0390625,409607,136450,4500
"2016-06-16",135500,136000,133500,134500,102040.3828125,399199,136525,2500
"2016-06-17",136000,136500,133500,134500,102040.3828125,328695,136525,3000
"2016-06-20",136000,138500,135500,136500,103557.71875,305307,136750,3000
"2016-06-21",136500,139000,135500,138000,104695.7109375,353879,137000,3500
"2016-06-22",138500,141500,138500,140000,106213.03125,413267,137325,3000
"2016-06-23",140500,141500,140000,141000,106971.703125,273960,137625,1500
"2016-06-24",140500,142000,134500,139500,105833.703125,901574,137850,7500
"2016-06-27",141000,144000,139500,141500,107351.03125,1031506,138125,4500
"2016-06-28",141500,142000,138500,139000,105454.3671875,570526,138250,3500
"2016-06-29",140000,140000,137500,139000,106218.5234375,436045,138225,2500
"2016-06-30",138000,138500,135500,135500,103543.96875,2700499,138100,3000
"2016-07-01",136500,138000,136000,137000,104690.1953125,388387,138050,2000
"2016-07-04",138000,139500,137000,137000,104690.1953125,518981,137975,2500
"2016-07-05",136500,137000,134500,135000,103161.890625,389267,137750,2500
"2016-07-06",134000,134500,129000,130000,99341.0625,1098353,137275,5500
"2016-07-07",131500,132500,130500,131000,100105.234375,351312,136875,2000
"2016-07-08",131000,133000,129000,130500,99723.140625,472095,136450,4000
"2016-07-11",130500,132000,130500,131000,100105.234375,395952,136225,1500
"2016-07-12",131500,133000,131000,132000,100869.3828125,401323,135900,2000
"2016-07-13",133000,135500,132500,135500,103543.96875,567236,135900,3000
"2016-07-14",134000,134500,131000,131500,100487.3125,688220,135750,3500
"2016-07-15",132000,134000,132000,133000,101633.5625,608594,135675,2000
"2016-07-18",133000,134000,131000,132000,100869.3828125,417748,135450,3000
"2016-07-19",131500,132000,130000,130000,99341.0625,630163,135050,2000
"2016-07-20",129500,131000,129000,129500,98958.9921875,513880,134525,2000
"2016-07-21",130000,131000,128500,130000,99341.0625,459440,133975,2500
"2016-07-22",130000,130500,129000,129000,98576.9140625,364418,133450,1500
"2016-07-25",129500,136000,129500,135500,103543.96875,1182857,133150,6500
"2016-07-26",135000,139500,134000,136000,103926.0234375,1125762,133000,5500
"2016-07-27",137000,137500,135000,137000,104690.1953125,450182,132900,2500
"2016-07-28",137500,138000,135000,136000,103926.0234375,451570,132925,3000
"2016-07-29",135000,136000,132000,132000,100869.3828125,698032,132675,4000
"2016-08-01",132500,136000,132500,135500,103543.96875,510753,132600,3500
"2016-08-02",135500,135500,133000,134000,102397.7265625,383193,132550,2500
"2016-08-03",133000,134000,130500,132000,100869.3828125,393748,132650,3500
"2016-08-04",132500,133000,129500,130500,99723.140625,552854,132625,3500
"2016-08-05",130500,133000,130500,133000,101633.5625,432472,132750,2500
"2016-08-08",134000,134000,132000,133000,101633.5625,367241,132850,2000
"2016-08-09",135000,137000,134500,136500,104308.125,590729,133075,2500
"2016-08-10",135500,137000,134000,134000,102397.7265625,495316,133000,3000
"2016-08-11",134000,135000,133500,134500,102779.8046875,340296,133150,1500
"2016-08-12",135000,136000,134500,136000,103926.0234375,441448,133300,1500
"2016-08-16",136000,137000,133000,133000,101633.5625,564040,133350,4000
"2016-08-17",133500,135000,133000,135000,103161.890625,456621,133600,2000
"2016-08-18",134500,135000,132000,132500,101251.484375,501557,133750,3000
"2016-08-19",133000,134000,132000,132500,101251.484375,375138,133875,2000
"2016-08-22",132500,133000,131000,132000,100869.3828125,400250,134025,2000
"2016-08-23",133000,134500,132000,132500,101251.484375,421660,133875,2500
"2016-08-24",132000,135500,131500,135500,103543.96875,725511,133850,4000
"2016-08-25",136000,138000,134000,136500,104308.125,880226,133825,4000
"2016-08-26",136500,137000,135000,135500,103543.96875,426273,133800,2000
"2016-08-29",134000,134500,133000,134000,102397.7265625,328229,133900,1500
"2016-08-30",133500,135000,132500,132500,101251.484375,331306,133750,2500
"2016-08-31",132000,133500,131000,133000,101633.5625,621524,133700,2500
"2016-09-01",133000,133500,131500,131500,100487.3125,572941,133675,2000
"2016-09-02",132500,136500,132000,135000,103161.890625,1129376,133900,4500
"2016-09-05",136000,139000,136000,139000,106218.5234375,681920,134200,3000
"2016-09-06",138500,140000,138000,139500,106600.6171875,455216,134525,2000
"2016-09-07",139500,140500,138000,139000,106218.5234375,515978,134650,2500
"2016-09-08",139000,140000,136500,139000,106218.5234375,604332,134900,3500
"2016-09-09",138000,140000,137500,139500,106600.6171875,430914,135150,2500
"2016-09-12",138500,139500,137500,138500,105836.4453125,447847,135275,2000
"2016-09-13",140000,140500,138000,138500,105836.4453125,560421,135550,2500
"2016-09-19",137000,139500,136000,137000,104690.1953125,536712,135650,3500
"2016-09-20",137000,139500,136500,138500,105836.4453125,517081,135950,3000
"2016-09-21",137500,138500,136500,138000,105454.3671875,464658,136225,2000
"2016-09-22",138000,139500,137500,138000,105454.3671875,360424,136525,2000
"2016-09-23",139500,142000,139000,142000,108510.9921875,595938,137000,3000
"2016-09-26",140500,141500,139000,140500,107364.765625,444564,137250,2500
"2016-09-27",140000,142000,138500,141500,108128.9453125,451975,137500,3500
"2016-09-28",141000,141500,138000,138500,105836.4453125,513300,137650,3500
"2016-09-29",138500,139500,138000,139500,106600.6171875,473726,137925,1500
"2016-09-30",138500,139500,135000,135500,103543.96875,617732,138075,4500
"2016-10-04",138500,141000,137500,139000,106218.5234375,707562,138375,3500
"2016-10-05",137500,140500,136500,140000,106982.703125,549606,138800,4000
"2016-10-06",139000,140000,138500,139000,106218.5234375,271808,139000,1500
"2016-10-07",138500,139000,135500,136500,104308.125,449894,138875,3500
"2016-10-10",134000,135000,131000,133500,102015.640625,687120,138575,4000
"2016-10-11",135000,135500,133500,134500,102779.8046875,355273,138350,2000
"2016-10-12",134500,137000,133500,136500,104308.125,418529,138225,3500
"2016-10-13",136500,137000,133500,134000,102397.7265625,444173,137950,3500
"2016-10-14",133500,135000,133000,133000,101633.5625,385561,137675,2000
"2016-10-17",134500,136500,133000,133000,101633.5625,552827,137400,3500
"2016-10-18",133500,135500,132500,134500,102779.8046875,357363,137275,3000
"2016-10-19",134500,135500,132500,133000,101633.5625,474445,137000,3000
"2016-10-20",133500,134000,131500,132000,100869.3828125,411425,136700,2500
"2016-10-21",132500,135000,132000,133500,102015.640625,375157,136475,3000
"2016-10-24",134500,134500,133500,134500,102779.8046875,256889,136100,1000
"2016-10-25",135000,139500,134500,138000,105454.3671875,863431,135975,5000
"2016-10-26",137500,138500,135000,137500,105072.296875,551856,135775,3500
"2016-10-27",139000,139500,135500,138000,105454.3671875,503571,135750,4000
"2016-10-28",138000,141500,137500,140500,107364.765625,708752,135800,4000
"2016-10-31",139000,141000,139000,140000,106982.703125,394472,136025,2000
"2016-11-01",141000,141500,140000,141500,108128.9453125,436941,136150,1500
"2016-11-02",141000,141500,139500,139500,106600.6171875,655976,136125,2000
"2016-11-03",139500,140000,136000,136500,104308.125,520972,136000,4000
"2016-11-04",136500,137000,135500,136000,103926.0234375,345493,135975,1500
"2016-11-07",137500,138000,136000,137000,104690.1953125,388228,136150,2000
"2016-11-08",137500,139500,137000,138500,105836.4453125,341446,136350,2500
"2016-11-09",138000,140000,130500,134000,102397.7265625,1054746,136225,9500
"2016-11-10",135000,135000,129000,129000,98576.9140625,1253550,135975,6000
"2016-11-11",130000,132000,130000,131500,100487.3125,571291,135900,2000
"2016-11-14",132000,134000,131000,132000,100869.3828125,369913,135850,3000
"2016-11-15",131500,132000,129500,130500,99723.140625,416685,135650,2500
"2016-11-16",130500,133500,130000,131000,100105.234375,379475,135550,3500
"2016-11-17",131000,133000,131000,132000,100869.3828125,217101,135550,2000
"2016-11-18",131500,132000,129500,129500,98958.9921875,282286,135350,2500
"2016-11-21",130000,133500,129500,133500,102015.640625,392922,135300,4000
"2016-11-22",133500,134500,132500,133500,102015.640625,366844,135075,2000
"2016-11-23",134500,135000,132500,134000,102397.7265625,292727,134900,2500
"2016-11-24",133500,136000,133000,135000,103161.890625,340767,134750,3000
"2016-11-25",135500,136000,134500,136000,103926.0234375,180033,134525,1500
"2016-11-28",135000,136000,133500,135000,103161.890625,256341,134275,2500
"2016-11-29",133000,135500,133000,134500,102779.8046875,312216,133925,2500
"2016-11-30",133500,134500,132500,133000,101633.5625,1188767,133600,2000
"2016-12-01",133000,135500,132000,132000,100869.3828125,478362,133375,3500
"2016-12-02",134000,136000,133000,133500,102015.640625,403575,133250,3000
"2016-12-05",134500,135500,133000,134000,102397.7265625,244209,133100,2500
"2016-12-06",135500,137000,135000,136500,104308.125,374760,133000,2000
"2016-12-07",138000,138000,136500,136500,104308.125,279131,133125,1500
"2016-12-08",138500,142000,138000,142000,108510.9921875,889649,133775,4000
"2016-12-09",142000,145000,141000,144000,110039.3125,647418,134400,4000
"2016-12-12",146000,148000,143500,144500,110421.4375,378077,135025,4500
"2016-12-13",144500,145000,142500,145000,110803.515625,283933,135750,2500
"2016-12-14",144500,145000,142000,143500,109657.28125,261384,136375,3000
"2016-12-15",142000,143000,141000,142000,108510.9921875,285737,136875,2000
"2016-12-16",141000,142000,139000,139500,106600.6171875,523767,137375,3000
"2016-12-19",140000,142500,139500,142000,108510.9921875,293868,137800,3000
"2016-12-20",141500,144000,141500,143500,109657.28125,399511,138300,2500
"2016-12-21",144500,144500,142500,143500,109657.28125,310188,138775,2000
"2016-12-22",143000,143000,141000,142000,108510.9921875,334338,139125,2000
"2016-12-23",143000,144000,142000,144000,110039.3125,357914,139525,2000
"2016-12-26",143500,145000,143500,144500,110421.4375,206099,140000,1500
"2016-12-27",144500,145000,144000,144500,110421.4375,337224,140500,1000
"2016-12-28",142500,144000,141500,143500,111982.1640625,377265,141025,2500
"2016-12-29",142500,146000,142000,146000,113933.0390625,381283,141725,4000
"2017-01-02",146000,150500,145500,150000,117054.5,545854,142550,5000
"2017-01-03",151000,154000,150000,153000,119395.59375,723246,143500,4000
"2017-01-04",152500,155000,152000,154000,120175.9375,601826,144375,3000
"2017-01-05",154000,154500,152000,153500,119785.7421875,391604,145225,2500
"2017-01-06",152000,153000,149500,151000,117834.8671875,366091,145675,3500
"2017-01-09",151000,151500,149500,150500,117444.703125,325146,146000,2000
"2017-01-10",150500,153000,150500,152000,118615.25,411333,146375,2500
"2017-01-11",150500,150500,147500,148500,115883.9375,675973,146550,3000
"2017-01-12",148000,151000,147500,148000,115493.765625,433867,146775,3500
"2017-01-13",149000,150000,148500,149000,116274.140625,293211,147125,1500
"2017-01-16",148500,151000,148500,150500,117444.703125,316413,147675,2500
"2017-01-17",150000,154000,149500,153500,119785.7421875,487662,148250,4500
"2017-01-18",153000,155500,151000,154000,120175.9375,395088,148775,4500
"2017-01-19",153000,153500,151000,152000,118615.25,255111,149200,2500
"2017-01-20",150500,153500,150000,153000,119395.59375,310228,149750,3500
"2017-01-23",151500,152000,148500,149000,116274.140625,424036,150000,3500
"2017-01-24",149500,149500,145500,146500,114323.25,518186,150100,4000
"2017-01-25",146500,147500,141500,142000,110811.5703125,749465,149975,6000
"2017-01-26",143500,143500,139500,142500,111201.7734375,632413,149925,4000
"2017-01-31",141500,142500,139000,139500,108860.6953125,574213,149600,3500
"2017-02-01",140000,141000,139000,139500,108860.6953125,446549,149075,2000
"2017-02-02",140000,140000,135500,136000,106129.3828125,610731,148225,4500
"2017-02-03",136500,139000,136000,137500,107299.9609375,453051,147400,3000
"2017-02-06",139000,139500,136000,136500,106519.6015625,293891,146550,3500
"2017-02-07",138000,140000,137500,139000,108470.5078125,395508,145950,2500
"2017-02-08",138500,139500,137000,139000,108470.5078125,415346,145375,2500
"2017-02-09",139500,141000,137500,140000,109250.875,513611,144775,3500
"2017-02-10",141000,141500,139000,141000,110031.25,330000,144400,2500
"2017-02-13",141500,141500,139000,139500,108860.6953125,320997,143975,2500
"2017-02-14",140000,140500,139500,140000,109250.875,295126,143525,1000
"2017-02-15",141500,146500,141500,145500,113542.8828125,682399,143275,5000
"2017-02-16",146500,151500,146500,150500,117444.703125,991329,143125,5000
"2017-02-17",149500,151000,148000,150500,117444.703125,484244,142950,3000
"2017-02-20",149500,151000,149500,150000,117054.5,239916,142850,1500
"2017-02-21",150000,151500,149000,151000,117834.8671875,324845,142750,2500
"2017-02-22",150000,151000,147000,149500,116664.3203125,423978,142775,4000
"2017-02-23",150500,150500,145000,146000,113933.0390625,790326,142750,5500
"2017-02-24",147000,148500,146500,148000,115493.765625,248236,143050,2000
"2017-02-27",148500,149000,146500,148500,115883.9375,183801,143350,2500
"2017-02-28",148500,150000,146500,149500,116664.3203125,476960,143850,3500
"2017-03-02",149000,150500,148500,148500,115883.9375,660227,144300,2000
"2017-03-03",147000,148000,141000,142000,110811.5703125,774281,144600,7000
"2017-03-06",141500,145000,140000,145000,113152.6953125,568168,144975,5000
"2017-03-07",143000,146000,143000,144000,112372.3046875,361237,145350,3000
"2017-03-08",144000,144500,141500,144500,112762.5234375,430524,145625,3000
"2017-03-09",144500,145500,143500,145000,113152.6953125,516356,145925,2000
"2017-03-10",145000,146500,143500,146000,113933.0390625,418788,146225,3000
"2017-03-13",145500,147000,145000,146000,113933.0390625,346033,146475,2000
"2017-03-14",147000,149500,146500,149000,116274.140625,402984,146950,3000
"2017-03-15",148500,149500,147500,149500,116664.3203125,415972,147425,2000
"2017-03-16",151500,152500,149000,151500,118225.0703125,511511,147725,3500
"2017-03-17",152500,152500,150000,151500,118225.0703125,384871,147775,2500
"2017-03-20",152500,157000,151500,156500,122126.8828125,753898,148075,5500
"2017-03-21",158000,171000,157500,170000,132661.765625,2100147,149075,13500
"2017-03-22",167500,170500,165500,170000,132661.765625,1095061,150025,5000
"2017-03-23",168500,169000,165000,165000,128760,786599,150800,4000
"2017-03-24",164000,167000,162000,164000,127979.6015625,619369,151700,5000
"2017-03-27",162000,163000,159000,162000,126418.875,556569,152400,4000
"2017-03-28",162000,163000,158500,160000,124858.1484375,528384,152975,4500
"2017-03-29",159500,160500,155500,156000,121736.6796875,594310,153300,5000
"2017-03-30",156500,160000,156500,158500,123687.5859375,541928,153800,3500
"2017-03-31",159500,160500,156000,157500,122907.234375,518427,154575,4500
"2017-04-03",156500,157000,153000,156500,122126.8828125,568863,155150,4000
"2017-04-04",154000,155000,150000,152000,118615.25,693275,155550,5000
"2017-04-05",152500,152500,147000,150000,117054.5,738030,155825,5500
"2017-04-06",149500,150000,147500,148000,115493.765625,543682,155975,2500
"2017-04-07",148000,149500,144000,144500,112762.5234375,814773,155900,5500
"2017-04-10",145000,147500,144500,146000,113933.0390625,372373,155900,3000
"2017-04-11",145000,145000,142500,142500,111201.7734375,460813,155575,2500
"2017-04-12",143000,144500,141500,141500,110421.4296875,467523,155175,3000
"2017-04-13",143000,144500,141000,142500,111201.7734375,537212,154725,3500
"2017-04-14",141500,143000,141000,142500,111201.7734375,235481,154275,2000
"2017-04-17",142500,144000,141000,144000,112372.3046875,354807,153650,3000
"2017-04-18",144500,144500,141000,141000,110031.25,512212,152200,3500
"2017-04-19",140000,140500,136500,137000,106909.7734375,1028582,150550,4000
"2017-04-20",137000,142000,137000,141500,110421.4296875,837678,149375,5000
"2017-04-21",142000,143000,141000,141500,110421.4296875,520179,148250,2000
"2017-04-24",141000,141500,139500,141500,110421.4296875,474698,147225,2000
"2017-04-25",142500,146500,142000,144500,112762.5234375,670239,146450,4500
"2017-04-26",145000,152000,144500,151000,117834.8671875,1288277,146200,7500
"2017-04-27",150000,151000,146500,147000,114713.4140625,747891,145625,4500
"2017-04-28",144000,146000,142500,144000,112372.3046875,686242,144950,3500
"2017-05-02",143000,152000,143000,151000,117834.8671875,883476,144675,9000
"2017-05-04",150500,153000,149500,152000,118615.25,559335,144675,3500
"2017-05-08",152000,158000,150500,158000,123297.390625,754482,145075,7500
"2017-05-10",157000,160500,155500,156500,122126.8828125,902973,145500,5000
"2017-05-11",159000,159000,156500,157500,122907.234375,683676,146150,2500
"2017-05-12",156000,157000,153500,155000,120956.3125,546718,146600,3500
"2017-05-15",153000,156000,152000,154000,120175.9375,320821,147175,4000
"2017-05-16",155000,158000,154500,157500,122907.234375,479777,147975,3500
"2017-05-17",156000,159000,155000,158500,123687.5859375,344159,148775,4000
"2017-05-18",158000,166500,157500,165000,128760,1274106,149900,9000
"2017-05-19",167000,171000,160000,170000,132661.765625,1889722,151200,11000
"2017-05-22",169000,171000,167000,170000,132661.765625,679426,152650,4000
"2017-05-23",170000,173000,169000,170000,132661.765625,649405,154300,4000
"2017-05-24",168500,170000,163500,164000,127979.6015625,876331,155425,6500
"2017-05-25",164500,167000,163500,165000,128760,627476,156600,3500
"2017-05-26",165500,166500,163000,163500,127589.3984375,487868,157700,3500
"2017-05-29",163000,165000,161500,162000,126418.875,405130,158575,3500
"2017-05-30",162500,165500,161000,164000,127979.6015625,393584,159225,4500
"2017-05-31",162500,166000,162500,163000,127199.203125,568084,160025,3500
"2017-06-01",162500,166500,162500,165500,129150.1328125,439229,161100,4000
"2017-06-02",164500,165000,160500,163000,127199.203125,571120,161700,4500
"2017-06-05",163500,165500,161000,161500,126028.671875,371037,162175,4500
"2017-06-07",160000,160000,157000,159000,124077.765625,746365,162225,3000
"2017-06-08",159000,161000,158500,160000,124858.1484375,548233,162400,2500
"2017-06-09",160000,161000,158500,160000,124858.1484375,343795,162525,2500
"2017-06-12",158000,163500,158000,162500,126809.046875,390351,162900,5500
"2017-06-13",163000,167000,162000,164500,128369.78125,548527,163425,5000
"2017-06-14",165000,170000,164500,169000,131881.40625,638693,164000,5500
"2017-06-15",168000,169000,162000,163000,127199.203125,668866,164225,7000
"2017-06-16",163500,165000,162500,165000,128760,310581,164225,2500
"2017-06-19",164500,168000,163500,167000,130320.6796875,335858,164075,4500
"2017-06-20",166000,169000,165000,166500,129930.484375,373530,163900,4000
"2017-06-21",166000,166000,160000,160500,125248.3359375,557266,163425,6000
"2017-06-22",162000,162000,160000,161500,126028.671875,401279,163300,2000
"2017-06-23",162000,166000,162000,164000,127979.6015625,292130,163250,4000
"2017-06-26",163000,165000,162000,164000,127979.6015625,211301,163275,3000
"2017-06-27",163000,163500,160000,160500,125248.3359375,449056,163200,3500
"2017-06-28",160000,162500,159500,160000,124858.1484375,347569,163000,3000
"2017-06-29",159500,162500,159000,161000,126428.671875,400255,162900,3500
"2017-06-30",159500,162000,158000,159500,125250.7734375,337644,162600,4000
"2017-07-03",158500,164000,158000,163500,128391.84375,392228,162625,6000
"2017-07-04",162500,162500,157500,158500,124465.5,448579,162475,5000
"2017-07-05",158000,159000,155000,156000,122502.3125,533353,162325,4000
"2017-07-06",156500,157000,155000,155500,122109.71875,380091,162100,2000
"2017-07-07",153500,154500,150500,151500,118968.6171875,857341,161675,4000
"2017-07-10",151000,151500,147500,148000,116220.1640625,805494,160950,4000
"2017-07-11",148500,150000,146500,148000,116220.1640625,592204,160125,3500
"2017-07-12",149000,151000,148000,149000,117005.40625,592811,159125,3000
"2017-07-13",150000,151500,148000,149000,117005.40625,609170,158425,3500
"2017-07-14",150000,154500,149500,154000,120931.765625,776297,157875,5000
"2017-07-17",153500,154000,149500,150500,118183.3515625,503286,157050,4500
"2017-07-18",151000,151500,147000,148000,116220.1640625,531137,156125,4500
"2017-07-19",148500,149500,147000,148500,116612.7890625,480211,155525,2500
"2017-07-20",149000,149000,145000,148000,116220.1640625,482332,154850,4000
"2017-07-21",148000,148000,146500,147500,115827.5234375,303019,154025,1500
"2017-07-24",148000,148000,144500,145000,113864.3515625,558419,153075,3500
"2017-07-25",145000,147500,144500,146000,114649.6171875,769128,152350,3000
"2017-07-26",147000,150000,146500,148000,116220.1640625,1000733,151750,3500
"2017-07-27",148000,148500,144500,146500,115042.2734375,552184,151025,4000
"2017-07-28",146500,150000,146500,149500,117398.0625,857408,150525,3500
"2017-07-31",149500,149500,144500,145000,113864.3515625,871600,149600,5000
"2017-08-01",145000,147000,144500,145500,114256.9765625,415903,148950,2500
"2017-08-02",146500,148000,145500,147500,115827.5234375,462222,148525,2500
"2017-08-03",147500,149500,146000,148500,116612.7890625,643295,148175,3500
"2017-08-04",148000,151000,147000,150000,117790.6796875,520334,148100,4000
"2017-08-07",150500,151000,148000,148000,116220.1640625,280334,148100,3000
"2017-08-08",147000,147500,143500,144000,113079.0546875,655022,147900,4000
"2017-08-09",145000,146000,144000,146000,114649.6171875,391355,147750,2000
"2017-08-10",144500,146500,144000,145000,113864.3515625,576598,147550,2500
"2017-08-11",143500,145500,141000,142000,111508.515625,607681,146950,4500
"2017-08-14",142500,146000,142000,144500,113471.7109375,319856,146650,4000
"2017-08-16",145000,146000,143000,144500,113471.7109375,417168,146475,3000
"2017-08-17",143000,144500,141500,144000,113079.0546875,250791,146250,3000
"2017-08-18",144000,145500,143500,144500,113471.7109375,253371,146075,2000
"2017-08-21",145000,148500,143500,148000,116220.1640625,430402,146100,5000
"2017-08-22",148000,150000,145000,147000,115434.875,533818,146200,5000
"2017-08-23",146500,147500,145500,146500,115042.2734375,245112,146225,2000
"2017-08-24",146500,147000,143500,143500,112686.453125,505047,146000,3500
"2017-08-25",143500,145500,143000,144500,113471.7109375,362052,145900,2500
"2017-08-28",144000,146000,144000,144500,113471.7109375,319822,145650,2000
"2017-08-29",143000,144500,142500,144000,113079.0546875,332462,145600,2000
"2017-08-30",142500,144000,138500,143000,112293.796875,762771,145475,5500
"2017-08-31",142000,145000,139500,140500,110330.625,834907,145125,5500
"2017-09-01",141000,143500,139500,143000,112293.796875,541048,144850,4000
"2017-09-04",140000,142500,139500,140000,109937.984375,326756,144350,3000
"2017-09-05",141000,142000,137000,138000,108367.46875,546091,143850,5000
"2017-09-06",138000,138500,133500,136000,106796.8828125,694527,143450,5000
"2017-09-07",138000,139000,137000,138000,108367.46875,531212,143050,2000
"2017-09-08",138000,138500,133000,135500,106404.265625,637658,142575,5500
"2017-09-11",134500,136500,133500,135000,106011.6171875,488905,142225,3000
"2017-09-12",135000,137500,134500,136000,106796.8828125,379325,141800,3000
"2017-09-13",136500,137500,133500,134000,105226.359375,588704,141275,4000
"2017-09-14",134000,137000,133000,137000,107582.1640625,904204,140925,4000
"2017-09-15",135500,137000,134000,136500,107189.5390625,369517,140525,3000
"2017-09-18",136500,137500,135500,137000,107582.1640625,415861,139975,2000
"2017-09-19",136500,141000,136500,140000,109937.984375,627903,139625,4500
"2017-09-20",141000,143000,139500,142000,111508.515625,618904,139400,3500
"2017-09-21",140500,142000,138500,141500,111115.8984375,467712,139300,3500
"2017-09-25",141000,143000,140000,141000,110723.2578125,307434,139125,3000
"2017-09-26",141000,141000,141000,141000,110723.2578125,0,138950,0
"2017-09-27",146000,149000,145500,147500,115827.5234375,623568,139125,3500
"2017-09-28",147000,148000,145000,147000,115434.875,541478,139325,3000
"2017-09-29",148500,151000,147500,150500,118183.3515625,808779,139825,3500
"2017-10-10",149500,152000,147500,151000,118575.953125,886098,140225,4500
"2017-10-11",151000,156500,151000,155000,121717.0546875,993821,140975,5500
"2017-10-12",155000,156500,152500,156500,122894.9609375,576444,141900,4000
"2017-10-13",155000,155500,152000,154500,121324.4140625,644646,142825,3500
"2017-10-16",154500,155000,152000,153000,120146.5078125,521198,143575,3000
"2017-10-17",153000,153500,148500,149500,117398.0625,510688,144275,5000
"2017-10-18",148000,153500,147000,150500,118183.3515625,695484,145050,6500
"2017-10-19",152000,154000,150500,151500,118968.6171875,474052,145825,3500
"2017-10-20",151500,152500,150500,151500,118968.6171875,227605,146700,2000
"2017-10-23",151000,153000,150500,151500,118968.6171875,387789,147425,2500
"2017-10-24",151500,152500,150000,151000,118575.953125,357958,148150,2500
"2017-10-25",150000,150500,146500,148500,116612.7890625,829299,148725,4000
"2017-10-26",148500,160000,148000,159500,125250.7734375,1550507,149700,12000
"2017-10-27",159500,161500,156500,158500,124465.5,776439,150525,5000
"2017-10-30",160000,160500,154500,156000,122502.3125,540408,151250,6000
"2017-10-31",157000,162000,156000,161000,126428.671875,905364,152250,6000
"2017-11-01",159000,162000,158500,160500,126036.046875,601287,153225,3500
"2017-11-02",159000,160500,158000,160000,125643.421875,353460,153850,2500
"2017-11-03",161000,164000,159500,161500,126821.3046875,426678,154575,4500
"2017-11-06",160000,163000,157500,158500,124465.5,530662,154975,5500
"2017-11-07",157000,159500,153500,155000,121717.0546875,754723,155175,6000
"2017-11-08",153500,157000,153500,155000,121717.0546875,384213,155175,3500
"2017-11-09",156000,156000,153000,155500,122109.71875,543762,155125,3000
"2017-11-10",154000,155500,153500,154500,121324.4140625,333985,155125,2000
"2017-11-13",156500,161500,156000,160500,126036.046875,664551,155500,5500
"2017-11-14",160000,160500,157500,160500,126036.046875,493631,156050,3000
"2017-11-15",161500,163000,160000,161500,126821.3046875,568064,156600,3000
"2017-11-16",162000,162000,158000,159500,125250.7734375,392185,157000,4000
"2017-11-17",158000,159000,156000,157000,123287.609375,493488,157275,3000
"2017-11-20",155500,157500,154000,156500,122894.9609375,392823,157525,3500
"2017-11-21",157000,158500,156000,157000,123287.609375,279920,157825,2500
"2017-11-22",157000,159000,155000,155000,121717.0546875,298605,158150,4000
"2017-11-23",156000,157000,154500,157000,123287.609375,327088,158025,2500
"2017-11-24",156000,159500,155500,159000,124858.1484375,414474,158050,4000
"2017-11-27",158500,160000,158000,158500,124465.5,508762,158175,2000
"2017-11-28",156500,160500,155000,157000,123287.609375,360463,157975,5500
"2017-11-29",158000,161000,157500,160500,126036.046875,550470,157975,3500
"2017-11-30",163000,166500,162500,164500,129177.125,1207560,158200,4000
"2017-12-01",164500,165500,161500,161500,126821.3046875,529049,158200,4000
"2017-12-04",160500,160500,157500,160500,126036.046875,412767,158300,3000
"2017-12-05",159000,162500,159000,161500,126821.3046875,298181,158625,3500
"2017-12-06",159500,162500,159500,162000,127213.96875,435843,158975,3000
"2017-12-07",163000,163000,160000,161500,126821.3046875,317111,159275,3000
"2017-12-08",159500,161000,157000,158500,124465.5,562488,159475,4000
"2017-12-11",158000,158500,149500,150000,117790.6796875,1235495,158950,9000
"2017-12-12",149000,151500,148000,150000,117790.6796875,594577,158425,3500
"2017-12-13",151500,152500,150000,151500,118968.6171875,449530,157925,2500
"2017-12-14",151000,154500,150500,150500,118183.3515625,848663,157475,4000
"2017-12-15",151500,154000,150500,154000,120931.765625,414172,157325,3500
"2017-12-18",154000,155000,152000,154000,120931.765625,304658,157200,3000
"2017-12-19",154000,155500,152500,153000,120146.5078125,301402,157000,3000
"2017-12-21",151500,152500,150000,150000,117790.6796875,393766,156750,2500
"2017-12-22",151000,153000,150500,153000,120146.5078125,257517,156550,2500
"2017-12-26",152000,155000,151500,154000,120931.765625,319229,156300,3500
"2017-12-27",151500,157000,150000,156500,125336.578125,445829,156200,7000
"2017-12-28",154500,156000,152000,156000,124936.1484375,405259,156150,4000
"2018-01-02",150500,153000,149000,149500,119730.46875,731763,155600,4000
"2018-01-03",149000,151000,149000,150500,120531.3671875,450874,154900,2000
"2018-01-04",150500,151000,146000,146500,117327.859375,931558,154150,5000
"2018-01-05",146000,149000,145500,149000,119330.0546875,463695,153575,3500
"2018-01-08",148500,151000,147500,151000,120931.765625,482619,153050,3500
"2018-01-09",151000,152500,149500,152500,122133.0625,465845,152575,3000
"2018-01-10",152500,158000,152000,155500,124535.7109375,793679,152275,6000
"2018-01-11",156000,156500,152500,155000,124135.265625,476891,152100,4000
"2018-01-12",153500,156000,153500,154000,123334.421875,424738,152300,2500
"2018-01-15",154000,155000,151000,155000,124135.265625,315592,152550,4000
"2018-01-16",153500,158000,153000,158000,126537.90625,440542,152875,5000
"2018-01-17",157000,159000,156000,157500,126137.453125,363034,153225,3000
"2018-01-18",157500,158000,154000,155000,124135.265625,324686,153275,4000
"2018-01-19",155000,162000,154500,162000,129741.3984375,637243,153675,7500
"2018-01-22",162500,164000,158500,162500,130141.8125,582519,154150,5500
"2018-01-23",163000,167500,161000,161000,128940.4921875,727921,154700,6500
"2018-01-24",160500,162000,156000,156500,125336.578125,653451,154875,6000
"2018-01-25",155500,159000,154000,158500,126938.3515625,776214,155100,5000
"2018-01-26",155000,155500,149000,152500,122133.0625,1058626,154900,6500
"2018-01-29",153000,155500,152000,154500,123734.8359375,504827,154825,3500
"2018-01-30",155000,158000,154500,156000,124936.1484375,458611,155150,3500
"2018-01-31",157000,162000,154500,162000,129741.3984375,926031,155725,7500
"2018-02-01",161500,162000,158500,160500,128540.0859375,478000,156425,3500
"2018-02-02",161000,164000,160500,162500,130141.8125,813167,157100,3500
"2018-02-05",162500,163000,159000,159000,127338.7734375,670474,157500,4000
"2018-02-06",158000,161000,153500,157500,126137.453125,690538,157750,7500
"2018-02-07",157500,160500,156000,157500,126137.453125,552642,157850,4500
"2018-02-08",158500,163500,156500,161000,128940.4921875,883512,158150,7000
"2018-02-09",156500,158500,154500,155000,124135.265625,721962,158200,4000
"2018-02-12",155500,156500,153500,154000,123334.421875,554120,158150,3000
"2018-02-13",154000,155500,152000,152500,122133.0625,528608,157875,3500
"2018-02-14",152000,155000,152000,154500,123734.8359375,265716,157725,3000
"2018-02-19",156500,157000,154500,155000,124135.265625,265257,157725,2500
"2018-02-20",155000,156000,152500,153500,122933.9765625,218792,157300,3500
"2018-02-21",152500,161000,152500,160000,128139.640625,537567,157175,8500
"2018-02-22",159000,159500,156000,157000,125737,339005,156975,3500
"2018-02-23",158500,159500,157500,159000,127338.7734375,275917,157100,2000
"2018-02-26",159000,162000,157500,161000,128940.4921875,513314,157225,4500
"2018-02-27",160500,162000,160000,161000,128940.4921875,273491,157650,2000
"2018-02-28",159000,163000,158000,161500,129340.9609375,496851,158000,5000
"2018-03-02",158000,159000,154500,156000,124936.1484375,591106,158000,4500
"2018-03-05",155500,157000,152500,153000,122533.5390625,410894,157550,4500
"2018-03-06",154500,158000,154500,157000,125737,375611,157375,3500
"2018-03-07",154000,155000,152000,152500,122133.0625,598406,156875,3000
"2018-03-08",153500,155000,152000,154500,123734.8359375,488545,156650,3000
"2018-03-09",153500,155000,152500,154000,123334.421875,460548,156475,2500
"2018-03-12",154000,155500,153000,153500,122933.9765625,422236,156275,2500
"2018-03-13",152500,155000,152500,153500,122933.9765625,378343,155900,2500
"2018-03-14",152500,157000,152000,156000,124936.1484375,605609,155950,5000
"2018-03-15",156500,159000,155000,157500,126137.453125,367882,156125,4000
"2018-03-16",158000,159500,156000,157500,126137.453125,351970,156375,3500
"2018-03-19",152500,153000,150000,151500,121332.21875,749609,156225,3000
"2018-03-20",150500,153500,150000,152500,122133.0625,311027,156100,3500
"2018-03-21",152500,155000,152500,154500,123734.8359375,277076,156150,2500
"2018-03-22",154500,154500,152000,152500,122133.0625,330219,155775,2500
"2018-03-23",151000,153000,150500,151500,121332.21875,578521,155500,2500
"2018-03-26",151000,152500,149500,149500,119730.46875,466599,155025,3000
"2018-03-27",150000,154000,149500,154000,123334.421875,683470,154675,4500
"2018-03-28",153000,155000,148000,151500,121332.21875,905733,154200,7000
"2018-03-29",150500,152000,142500,143500,114925.25,1532300,153300,9500
"2018-03-30",144000,145500,142500,143500,114925.25,525910,152675,3000
"2018-04-02",144500,148500,144000,148500,118929.59375,569272,152450,4500
"2018-04-03",147000,152500,145500,152000,121732.65625,2258712,152200,7000
"2018-04-04",156000,159500,155000,156500,125336.578125,1198367,152400,4500
"2018-04-05",157000,158000,153500,154000,123334.421875,404008,152375,4500
"2018-04-06",155000,155500,152000,152500,122133.0625,377964,152300,3500
"2018-04-09",152000,153000,150500,151000,120931.765625,319141,152175,2500
"2018-04-10",150000,153000,149000,151000,120931.765625,371422,152050,4000
"2018-04-11",150500,152000,150000,150000,120130.921875,329076,151750,2000
"2018-04-12",151000,152500,150000,152000,121732.65625,297375,151475,2500
"2018-04-13",151500,152000,149500,150500,120531.3671875,425396,151125,2500
"2018-04-16",151000,154000,150000,153000,122533.5390625,303065,151200,4000
"2018-04-17",154000,158000,154000,157500,126137.453125,670905,151450,4000
"2018-04-18",158000,159500,157000,158500,126938.3515625,507655,151650,2500
"2018-04-19",157500,158000,155000,158000,126537.90625,344290,151925,3000
"2018-04-20",157000,160000,156500,160000,128139.640625,406412,152350,3500
"2018-04-23",160000,160000,157000,159500,127739.21875,284140,152850,3000
"2018-04-24",161500,165500,161500,162500,130141.8125,644850,153275,4000
"2018-04-25",162000,164000,160000,164000,131343.125,407673,153900,4000
"2018-04-26",164000,164000,154500,156500,125336.578125,861668,154550,9500
"2018-04-27",155000,161500,154000,158000,126537.90625,887506,155275,7500
"2018-04-30",159000,160500,157000,160000,128139.640625,351811,155850,3500
"2018-05-02",159000,160500,157000,160000,128139.640625,377086,156250,3500
"2018-05-03",162500,163000,160000,160000,128139.640625,324816,156425,3000
"2018-05-04",158000,160000,156500,158000,126537.90625,448848,156625,3500
"2018-05-08",158500,161000,154500,156000,124936.1484375,595219,156800,6500
"2018-05-09",154500,156000,153500,153500,122933.9765625,513770,156925,2500
"2018-05-10",152500,154000,150500,152000,121732.65625,747954,156975,3500
"2018-05-11",152000,154000,151500,153000,122533.5390625,319288,157125,2500
"2018-05-14",153500,154500,150500,151000,120931.765625,439028,157075,4000
"2018-05-15",150000,151500,148000,148500,118929.59375,611470,156975,3500
"2018-05-16",148500,151500,146000,150500,120531.3671875,599945,156850,5500
"2018-05-17",150500,151000,149500,149500,119730.46875,297968,156450,1500
"2018-05-18",148500,150000,148000,150000,120130.921875,330193,156025,2000
"2018-05-21",149500,151000,149000,149000,119330.0546875,332251,155575,2000
"2018-05-23",147000,148500,144000,144500,115726.109375,1062994,154800,4500
"2018-05-24",144000,144500,139000,140000,112122.203125,1387498,153825,5500
"2018-05-25",139500,141000,138500,139000,111321.3046875,697859,152650,2500
"2018-05-28",139000,140500,138000,138500,110920.8671875,498199,151375,2500
"2018-05-29",139500,141000,139000,140000,112122.203125,471953,150550,2000
"2018-05-30",138500,139500,136000,137500,110120.0078125,648596,149525,3500
"2018-05-31",139000,140000,137500,139000,111321.3046875,835047,148475,2500
"2018-06-01",138500,140000,137500,140000,112122.203125,395619,147475,2500
"2018-06-04",140000,144000,139000,143000,114524.8046875,903195,146625,5000
"2018-06-05",143500,144000,140500,142500,114124.3515625,374748,145850,3500
"2018-06-07",142000,144000,141500,142500,114124.3515625,511413,145175,2500
"2018-06-08",142000,142500,140000,141000,112923.0390625,539842,144550,2500
"2018-06-11",140000,140500,139000,139500,111721.75,441032,143925,1500
"2018-06-12",140000,142000,139500,140500,112522.6328125,486396,143300,2500
"2018-06-14",138500,139000,135000,135000,108117.8203125,1036041,142500,4000
"2018-06-15",136000,136500,133000,134000,107316.953125,762750,141775,3500
"2018-06-18",134500,136500,134500,135000,108117.8203125,497745,141000,2000
"2018-06-19",134000,135000,131000,131500,105314.7734375,781548,140100,4000
"2018-06-20",130500,131500,129000,129500,103713.0234375,595333,139075,2500
"2018-06-21",129500,130500,127000,127000,101710.8359375,608003,137975,3500
"2018-06-22",126000,131000,125000,130000,104113.4609375,716503,137250,6000
"2018-06-25",129500,130000,128000,129000,103312.578125,563769,136700,2000
"2018-06-26",128000,131000,127500,129500,103713.0234375,703936,136225,3500
"2018-06-27",129000,130500,125500,127500,102111.2734375,935679,135675,5000
"2018-06-28",126000,126500,123000,125000,100900.4765625,1101059,134925,3500
"2018-06-29",124500,126000,123500,125500,101304.0625,496503,134325,2500
"2018-07-02",125000,125500,123000,123500,99689.65625,428578,133550,2500
"2018-07-03",125500,125500,119500,122000,98478.84375,556533,132650,6000
"2018-07-04",120500,122500,118000,119500,96460.8515625,510210,131475,4500
"2018-07-05",119000,122000,118000,121500,98075.2578125,845590,130425,4000
"2018-07-06",122500,126000,122500,123500,99689.65625,658197,129475,3500
"2018-07-09",124000,125000,122500,124500,100496.8515625,303024,128650,2500
"2018-07-10",123500,125500,122500,123500,99689.65625,328075,127850,3000
"2018-07-11",121000,123000,120500,121500,98075.2578125,384762,126900,2500
"2018-07-12",121500,125000,121000,123000,99286.0546875,613187,126300,4000
"2018-07-13",123500,125000,122000,122500,98882.4453125,306680,125725,3000
"2018-07-16",122500,127500,122500,126000,101707.671875,494043,125275,5000
"2018-07-17",126000,129000,125000,126500,102111.2734375,436989,125025,4000
"2018-07-18",127000,128500,124000,124000,100093.2734375,325090,124750,4500
"2018-07-19",125000,125500,123500,124000,100093.2734375,359064,124600,2000
"2018-07-20",124500,128500,122500,127000,102514.8828125,463776,124450,6000
"2018-07-23",127500,131000,127000,129500,104532.890625,660426,124475,4000
"2018-07-24",129500,130000,126500,129500,104532.890625,479217,124475,3500
"2018-07-25",130000,130500,129000,130500,105340.1015625,305338,124625,1500
"2018-07-26",131000,131500,128000,130000,104936.46875,484321,124875,3500
"2018-07-27",129500,131500,129000,129500,104532.890625,365369,125075,2500
"2018-07-30",129000,131000,128500,130500,105340.1015625,179748,125425,2500
"2018-07-31",131000,131000,128500,129500,104532.890625,306556,125800,2500
"2018-08-01",130000,130500,128000,128500,103725.6796875,244440,126250,2500
"2018-08-02",128000,128500,124000,125500,101304.0625,425332,126450,4500
"2018-08-03",124000,125500,124000,124000,100093.2734375,468331,126475,1500
"2018-08-06",124500,126000,124000,124500,100496.8515625,317150,126475,2000
"2018-08-07",124000,126000,123500,125000,100900.4765625,285278,126550,2500
"2018-08-08",125500,129500,125500,127500,102918.4921875,816582,126850,4000
"2018-08-09",126500,127500,125500,126000,101707.671875,532068,127000,2000
"2018-08-10",126000,127000,124500,126000,101707.671875,194355,127175,2500
"2018-08-13",125000,126000,123000,123500,99689.65625,319273,127050,3000
"2018-08-14",124500,125000,122500,123000,99286.0546875,291859,126875,2500
"2018-08-16",122000,127000,122000,126500,102111.2734375,561446,127000,5000
"2018-08-17",125500,127000,125000,126500,102111.2734375,207735,127125,2000
"2018-08-20",127500,128000,126000,127500,102918.4921875,310969,127150,2000
"2018-08-21",127000,127500,124000,125500,101304.0625,339831,126950,3500
"2018-08-22",125500,127000,124500,126000,101707.671875,329800,126775,2500
"2018-08-23",125500,126000,123000,124500,100496.8515625,229027,126475,3000
"2018-08-24",123500,124500,123000,124500,100496.8515625,232363,126200,1500
"2018-08-27",125000,125500,123500,124000,100093.2734375,226756,125925,2000
"2018-08-28",125000,127000,124000,125000,100900.4765625,402853,125650,3000
"2018-08-29",125000,125000,123500,124000,100093.2734375,309579,125375,1500
"2018-08-30",124000,125000,123000,123500,99689.65625,385998,125125,2000
"2018-08-31",124000,126000,123000,125000,100900.4765625,529278,125100,3000
"2018-09-03",124500,126000,123500,125000,100900.4765625,264041,125150,2500
"2018-09-04",125500,127000,124500,126500,102111.2734375,297393,125250,2500
"2018-09-05",126500,131000,126500,129000,104129.2890625,871735,125450,4500
"2018-09-06",130000,136000,130000,134000,108165.3046875,935048,125775,6000
"2018-09-07",136000,137000,131500,133000,107358.109375,793026,126125,5500
"2018-09-10",131500,133500,130000,131000,105743.6875,320236,126375,3500
"2018-09-11",130000,130500,128000,128000,103322.09375,514468,126600,2500
"2018-09-12",128500,131000,128000,129500,104532.890625,340635,126925,3000
"2018-09-13",130500,130500,128000,128500,103725.6796875,411245,127025,2500
"2018-09-14",129500,131000,129000,129500,104532.890625,259936,127175,2000
"2018-09-17",129000,129500,128000,128500,103725.6796875,305158,127225,1500
"2018-09-18",128500,130000,128000,128000,103322.09375,368661,127350,2000
"2018-09-19",128500,129000,125500,126500,102111.2734375,420484,127375,3500
"2018-09-20",126500,130000,126000,129000,104129.2890625,378436,127600,4000
"2018-09-21",131000,131000,127500,129000,104129.2890625,765535,127825,3500
"2018-09-27",130000,130500,128500,130500,105340.1015625,465760,128150,2000
"2018-09-28",130000,130500,128000,129500,104532.890625,295867,128375,2500
"2018-10-01",130000,130000,128500,129000,104129.2890625,233662,128625,1500
"2018-10-02",128500,129500,128000,128500,103725.6796875,215297,128875,1500
"2018-10-04",128500,129000,122500,124500,100496.8515625,671140,128850,6500
"2018-10-05",126000,126000,123000,124500,100496.8515625,284015,128825,3000
"2018-10-08",123500,124000,121500,122000,98478.84375,386710,128600,2500
"2018-10-10",122500,123000,119500,120000,96864.4453125,536984,128150,3500
"2018-10-11",118500,120500,116000,116000,93635.6328125,701523,127250,4500
"2018-10-12",115500,118000,114500,115500,93232.03125,672541,126375,3500
"2018-10-15",116500,117000,111500,113500,91617.625,697689,125500,5500
"2018-10-16",114000,117500,113500,116500,94039.25,503295,124925,4000
"2018-10-17",117500,119500,116500,118500,95653.640625,385112,124375,3000
"2018-10-18",118000,118500,114000,116000,93635.6328125,708181,123750,4500
"2018-10-19",114500,117500,114000,115500,93232.03125,493067,123050,3500
"2018-10-22",115000,118000,114500,118000,95250.0390625,378176,122525,3500
"2018-10-23",117000,118000,114000,116500,94039.25,575347,121950,4000
"2018-10-24",117500,118500,116000,117000,94442.84375,776694,121475,2500
"2018-10-25",116000,116000,102500,110000,88792.4296875,1633392,120525,13500
"2018-10-26",110000,113000,107500,108000,87178.015625,867074,119475,5500
"2018-10-29",106000,108500,104000,106000,85563.6015625,876545,118250,4500
"2018-10-30",106500,109500,106000,107500,86774.3984375,429587,117150,3500
"2018-10-31",106500,107000,103500,106500,85967.203125,752213,116025,3500
"2018-11-01",106500,109000,104500,108500,87581.6015625,487868,115025,4500
"2018-11-02",107000,110500,106500,110000,88792.4296875,586857,114300,4000
"2018-11-05",107000,107500,103500,104000,83949.1875,921610,113275,4000
"2018-11-06",105000,108500,104500,107500,86774.3984375,775343,112550,4000
"2018-11-07",106500,108000,105500,107500,86774.3984375,619311,111925,2500
"2018-11-08",109000,109000,105500,105500,85160.0078125,588487,111400,3500
"2018-11-09",106000,110000,104500,105000,84756.3984375,668003,110875,5500
"2018-11-12",105000,105500,100500,102000,82334.7734375,792697,110300,5000
"2018-11-13",99900,102500,99600,102500,82738.390625,397209,109600,2900
"2018-11-14",103500,104500,100500,101500,81931.1875,637102,108750,4000
"2018-11-15",101000,103500,100500,103000,83141.9921875,449187,108100,3000
"2018-11-16",104000,104500,102000,103000,83141.9921875,361507,107475,2500
"2018-11-19",103000,103500,101000,101500,81931.1875,555495,106650,2500
"2018-11-20",101000,101000,97100,97500,78702.375,1295271,105700,3900
"2018-11-21",96500,97900,95800,97800,78944.5234375,883111,104740,2100
"2018-11-22",98000,98000,92500,92800,74908.5078125,1527106,103880,5500
"2018-11-23",92800,94000,92600,93700,75634.9765625,558490,103165,1400
"2018-11-26",93600,95800,93500,95100,76765.078125,663188,102620,2300
"2018-11-27",95900,101500,95800,101000,81527.578125,1436195,102295,5700
"2018-11-28",100500,101500,99800,101000,81527.578125,602728,102020,1700
"2018-11-29",102000,103000,99100,1e+05,80720.375,811011,101595,3900
"2018-11-30",103000,108000,102500,107000,86370.796875,3017114,101445,5500
"2018-12-03",108500,109000,106500,108500,87581.6015625,723565,101670,2500
"2018-12-04",108500,108500,105500,107500,86774.3984375,612079,101670,3000
"2018-12-05",106000,108500,106000,107500,86774.3984375,519108,101670,2500
"2018-12-06",107500,112500,106000,110500,89196.0234375,896541,101920,6500
"2018-12-07",110000,112000,109500,111000,89599.6171875,566780,102220,2500
"2018-12-10",108500,111000,108500,110500,89196.0234375,367098,102645,2500
"2018-12-11",109500,112500,108500,111500,90003.203125,372363,103095,4000
"2018-12-12",111500,121500,111000,118500,95653.640625,1558536,103945,10500
"2018-12-13",116500,120000,116500,118500,95653.640625,1093587,104720,3500
"2018-12-14",119000,120000,115000,116500,94039.25,534429,105395,5000
"2018-12-17",115000,118500,112500,116500,94039.25,602835,106145,6000
"2018-12-18",117500,120000,116000,118000,95250.0390625,889260,107170,4000
"2018-12-19",118500,123500,118500,123000,99286.0546875,841175,108430,5000
"2018-12-20",121500,124500,120500,121500,98075.2578125,682779,109865,4000
"2018-12-21",120500,122500,119500,122500,98882.4453125,643918,111305,3000
"2018-12-24",122000,124000,121500,123000,99286.0546875,301455,112700,2500
"2018-12-26",121500,122000,118500,120000,96864.4453125,550552,113650,3500
"2018-12-27",118000,120000,117500,118500,98106.296875,458613,114525,2500
"2018-12-28",118500,120000,117500,118500,98106.296875,398062,115450,2500
"2019-01-02",117500,118000,113500,114000,94380.7421875,565493,115800,4500
"2019-01-03",113000,118500,113000,116500,96450.5078125,608591,116200,5500
"2019-01-04",116000,123000,116000,119500,98934.203125,1326978,116800,7000
"2019-01-07",121000,121500,119500,120500,99762.1171875,428416,117450,2000
"2019-01-08",121500,123500,118500,119500,98934.203125,582117,117900,5000
"2019-01-09",119000,124000,119000,123000,101831.8515625,846392,118500,5000
"2019-01-10",121500,123000,119500,123000,101831.8515625,648837,119125,3500
"2019-01-11",123000,124500,122000,123000,101831.8515625,440529,119700,2500
"2019-01-14",122500,124000,121000,121500,100590.0078125,297709,119850,3000
"2019-01-15",121000,128000,120500,127500,105557.421875,828015,120300,7500
"2019-01-16",127000,129000,126000,128500,106385.3125,397335,120900,3000
"2019-01-17",128500,130000,127500,129500,107213.21875,513711,121550,2500
"2019-01-18",129500,131500,129500,131000,108455.0625,556106,122200,2000
"2019-01-21",132000,132000,126500,127000,105143.46875,657273,122400,5500
"2019-01-22",126500,128000,125000,127500,105557.421875,446263,122700,3000
"2019-01-23",128000,130000,127000,129000,106799.265625,422209,123025,3000
"2019-01-24",128000,130000,124500,130000,107627.1484375,778826,123375,5500
"2019-01-25",127500,130000,127500,128500,106385.3125,535338,123800,2500
"2019-01-28",128500,130000,125500,126500,104729.5078125,541428,124200,4500
"2019-01-29",126500,128500,126000,128000,105971.375,445671,124675,2500
"2019-01-30",128500,129500,126500,129500,107213.21875,463542,125450,3000
"2019-01-31",130000,131000,128500,129500,107213.21875,509642,126100,2500
"2019-02-01",129500,130000,128500,129500,107213.21875,392755,126600,1500
"2019-02-07",128500,129000,125500,126000,104315.5546875,530165,126875,3500
"2019-02-08",125500,126500,124500,125500,103901.6015625,365392,127175,2000
"2019-02-11",126000,129000,126000,127500,105557.421875,425879,127400,3000
"2019-02-12",129000,129000,126500,128500,106385.3125,443035,127675,2500
"2019-02-13",128500,128500,124000,124500,103073.6953125,620173,127750,4500
"2019-02-14",123500,124000,119500,121500,100590.0078125,1072937,127750,4500
"2019-02-15",121000,121500,120000,121000,100176.0546875,446734,127425,1500
"2019-02-18",121000,122000,118500,120500,99762.1171875,557734,127025,3500
"2019-02-19",119500,120500,119000,119500,98934.203125,470357,126525,1500
"2019-02-20",119500,121500,119000,119000,98520.25,735087,125925,2500
"2019-02-21",118500,121000,118500,120000,99348.1484375,588691,125575,2500
"2019-02-22",119500,121500,119500,121000,100176.0546875,353516,125250,2000
"2019-02-25",120500,122500,120000,121000,100176.0546875,314081,124850,2500
"2019-02-26",121500,124000,121500,122500,101417.890625,781497,124475,2500
"2019-02-27",128000,130000,126000,129000,106799.265625,1233285,124500,4000
"2019-02-28",127500,129000,126000,126500,104729.5078125,946738,124500,3000
"2019-03-04",125000,126000,121000,122000,101003.9375,937284,124200,5000
"2019-03-05",121500,122000,119500,121500,100590.0078125,428825,123800,2500
"2019-03-06",122500,126500,121500,124500,103073.6953125,599316,123550,5000
"2019-03-07",126500,129000,123000,125500,103901.6015625,791500,123350,6000
"2019-03-08",125000,125000,120000,120000,99348.1484375,467762,123050,5000
"2019-03-11",121000,121500,119000,121000,100176.0546875,281873,122825,2500
"2019-03-12",121500,125500,121500,125500,103901.6015625,621289,122725,4000
"2019-03-13",126000,126000,120500,122500,101417.890625,797741,122425,5500
"2019-03-14",124000,124000,117000,119000,98520.25,1326511,122150,7000
"2019-03-15",119000,122000,118000,121000,100176.0546875,877363,122125,4000
"2019-03-18",122000,124000,121500,124000,102659.765625,383652,122275,2500
"2019-03-19",124000,125000,123000,124000,102659.765625,303901,122450,2000
"2019-03-20",123000,124000,121000,124000,102659.765625,316345,122675,3000
"2019-03-21",124000,126000,122500,124500,103073.6953125,321599,122950,3500
"2019-03-22",124000,125500,121500,123500,102245.796875,486194,123125,4000
"2019-03-25",121000,122000,119000,120000,99348.1484375,458292,123075,3000
"2019-03-26",120000,121000,118500,118500,98106.296875,463924,122950,2500
"2019-03-27",118500,119500,118000,118500,98106.296875,236825,122750,1500
"2019-03-28",118500,120000,118000,119500,98934.203125,304740,122275,2000
"2019-03-29",120000,122000,119000,119500,98934.203125,432923,121925,3000
"2019-04-01",120000,121000,119000,120500,99762.1171875,363959,121850,2000
"2019-04-02",119500,120000,117500,119000,98520.25,374423,121725,2500
"2019-04-03",118500,124000,118000,124000,102659.765625,651778,121700,6000
"2019-04-04",123000,125000,122500,123500,102245.796875,464644,121600,2500
"2019-04-05",124500,126500,124000,126000,104315.5546875,468793,121900,2500
"2019-04-08",126500,128500,125500,128000,105971.375,455205,122250,3000
"2019-04-09",125500,128000,125500,127000,105143.46875,317656,122325,2500
"2019-04-10",126500,128500,126500,127500,105557.421875,349261,122575,2000
"2019-04-11",127500,128000,125500,128000,105971.375,551990,123025,2500
"2019-04-12",127000,128000,125500,126500,104729.5078125,286762,123300,2500
"2019-04-15",126000,127000,125000,125500,103901.6015625,222997,123375,2000
"2019-04-16",126500,130500,125500,128500,106385.3125,753845,123600,5000
"2019-04-17",128500,131000,127500,131000,108455.0625,535629,123950,3500
"2019-04-18",133500,137000,132500,134000,110938.7734375,1523085,124425,4500
"2019-04-19",135000,135500,133000,134000,110938.7734375,335516,124950,2500
"2019-04-22",133000,134500,132000,134000,110938.7734375,231200,125650,2500
"2019-04-23",134000,137000,133000,136000,112594.578125,480332,126525,4000
"2019-04-24",139000,140000,136000,138500,114664.328125,1394398,127525,4000
"2019-04-25",138500,139000,136500,138000,114250.375,598551,128450,2500
"2019-04-26",138000,138500,134500,135500,112180.6484375,657701,129250,4000
"2019-04-29",136500,139500,136500,139000,115078.2734375,758885,130175,3000
"2019-04-30",139500,140500,138000,138500,114664.328125,623895,131150,2500
"2019-05-02",138000,140500,137000,138500,114664.328125,430420,131875,3500
"2019-05-03",137500,138500,136500,137500,113836.421875,430867,132575,2000
"2019-05-07",134500,137000,134000,136000,112594.578125,545860,133075,3000
"2019-05-08",134500,136000,134000,135500,112180.6484375,424168,133450,2000
"2019-05-09",135000,135500,131000,131000,108455.0625,810123,133650,4500
"2019-05-10",131500,134000,128000,130000,107627.1484375,544413,133775,6000
"2019-05-13",128000,131000,128000,129000,106799.265625,384073,133825,3000
"2019-05-14",128500,129500,127000,128000,105971.375,442314,133900,2500
"2019-05-15",127500,130000,125500,128000,105971.375,494972,134025,4500
"2019-05-16",133000,135000,127000,127500,105557.421875,1005933,133975,8000
"2019-05-17",127000,128500,125000,125500,103901.6015625,298037,133700,3500
"2019-05-20",125500,129500,125500,129000,106799.265625,825485,133450,4000
"2019-05-21",129000,129500,125000,127000,105143.46875,733503,133100,4500
"2019-05-22",127000,129000,126000,127000,105143.46875,381004,132750,3000
"2019-05-23",129000,129500,126500,127500,105557.421875,637184,132325,3000
"2019-05-24",127000,130500,126000,130500,108041.125,649719,131925,4500
"2019-05-27",130000,135500,130000,135000,111766.6640625,716578,131775,5500
"2019-05-28",135000,136500,133000,136500,113008.5234375,1209912,131825,3500
"2019-05-29",135000,135500,131500,134000,110938.7734375,637263,131575,4000
"2019-05-30",132500,136500,132500,135500,112180.6484375,495640,131425,4000
"2019-05-31",134500,135000,131000,134500,111352.7265625,925504,131225,4000
"2019-06-03",134000,138500,132500,138500,114664.328125,651551,131275,6000
"2019-06-04",137000,140500,137000,139000,115078.2734375,585901,131425,3500
"2019-06-05",139500,142000,139000,141000,116734.078125,608171,131700,3000
"2019-06-07",141500,142000,139500,140000,115906.203125,492290,132150,2500
"2019-06-10",142000,143000,140000,143000,118389.890625,468996,132800,3000
"2019-06-11",142500,143500,140500,143500,118803.828125,362392,133525,3000
"2019-06-12",143500,143500,139500,141000,116734.078125,535905,134175,4000
"2019-06-13",140500,141500,137500,141000,116734.078125,946951,134825,4000
"2019-06-14",140000,142500,139500,140500,116320.1328125,339897,135475,3000
"2019-06-17",140000,141500,139500,140000,115906.203125,228663,136200,2000
"2019-06-18",140500,141500,139500,141000,116734.078125,222606,136800,2000
"2019-06-19",140500,141000,139000,140000,115906.203125,303777,137450,2000
"2019-06-20",139500,141000,139000,140500,116320.1328125,259704,138125,2000
"2019-06-21",140000,141000,139500,140500,116320.1328125,291573,138775,1500
"2019-06-24",142000,143500,141500,142500,117975.9296875,287939,139375,2000
"2019-06-25",142500,142500,140500,141500,117148.015625,294735,139700,2000
"2019-06-26",141000,142000,140000,141500,117148.015625,239375,139950,2000
"2019-06-27",141000,142500,139500,140500,117148.03125,343337,140275,3000
"2019-06-28",140000,141000,139000,140000,116731.140625,274397,140500,2000
"2019-07-01",141500,142500,139500,141000,117564.9296875,328363,140825,3000
"2019-07-02",139500,140000,136500,137000,114229.7421875,444895,140750,3500
"2019-07-03",136000,138000,134000,136000,113395.9609375,582636,140600,4000
"2019-07-04",135500,139500,135000,139000,115897.34375,305720,140500,4500
"2019-07-05",139000,142000,138500,141500,117981.8125,338177,140575,3500
"2019-07-08",140500,142000,138000,138500,115480.4375,339244,140350,4000
"2019-07-09",139500,141500,137000,137500,114646.6484375,435577,140050,4500
"2019-07-10",139000,140000,135500,137000,114229.7421875,567104,139850,4500
"2019-07-11",136500,140500,135000,139000,115897.34375,1070266,139750,5500
"2019-07-12",138500,142000,138000,139500,116314.234375,549266,139700,4000
"2019-07-15",139500,140000,137000,138000,115063.546875,280032,139600,3000
"2019-07-16",139000,139000,132000,133000,110894.5703125,902923,139200,7000
"2019-07-17",133000,134500,132000,133500,111311.46875,375651,138875,2500
"2019-07-18",133000,134500,132500,134000,111728.375,355896,138550,2000
"2019-07-19",135500,135500,132000,134500,112145.28125,363374,138250,3500
"2019-07-22",134000,135500,132000,133000,110894.5703125,608574,137775,3500
"2019-07-23",133500,133500,128500,132000,110060.796875,1128639,137300,5000
"2019-07-24",131500,133500,131500,132500,110477.671875,419148,136850,2000
"2019-07-25",131500,133500,130000,131500,109643.8828125,613289,136400,3500
"2019-07-26",130500,132500,130000,130500,108810.1015625,394087,135925,2500
"2019-07-29",130000,131000,126500,128000,106725.609375,464288,135275,4500
"2019-07-30",129000,129500,126500,128000,106725.609375,321935,134825,3000
"2019-07-31",126500,129000,126500,126500,105474.921875,488189,134350,2500
"2019-08-01",126500,130000,125000,125500,104641.1171875,468797,133675,5000
"2019-08-02",126000,128500,124500,127500,106308.71875,605798,132975,4000
"2019-08-05",127500,128000,125500,127500,106308.71875,748862,132425,2500
"2019-08-06",126000,127500,123000,126000,105058.0234375,762619,131850,4500
"2019-08-07",126500,129000,126500,127000,105891.8203125,752576,131350,2500
"2019-08-08",129000,132500,128500,130000,108393.1796875,1303906,130900,4000
"2019-08-09",131500,132500,129000,132500,110477.671875,521574,130550,3500
"2019-08-12",131000,132500,130000,131000,109227,350563,130200,2500
"2019-08-13",129500,131000,129000,129000,107559.40625,334053,130000,2000
"2019-08-14",130000,131500,127000,127500,106308.71875,614128,129700,4500
"2019-08-16",126500,128000,125000,128000,106725.609375,352114,129400,3000
"2019-08-19",127500,129500,127500,128000,106725.609375,242024,129075,2000
"2019-08-20",127500,128500,125000,126500,105474.921875,481643,128750,3500
"2019-08-21",126500,127500,124000,125500,104641.1171875,530685,128425,3500
"2019-08-22",126000,126500,124000,124000,103390.4375,480559,128000,2500
"2019-08-23",123000,126000,123000,126000,105058.0234375,256322,127725,3000
"2019-08-26",124000,126000,123500,124500,103807.3203125,391828,127425,2500
"2019-08-27",125000,126500,124000,125000,104224.2265625,1043657,127275,2500
"2019-08-28",128500,130500,127000,127500,106308.71875,766622,127250,3500
"2019-08-29",127500,128000,126000,126500,105474.921875,393472,127250,2000
"2019-08-30",127500,129000,127000,128500,107142.5,433515,127400,2000
"2019-09-02",128000,132000,127500,131000,109227,385326,127575,4500
"2019-09-03",131500,132000,127500,128500,107142.5,505454,127625,4500
"2019-09-04",128000,129000,127000,128500,107142.5,496326,127750,2000
"2019-09-05",128000,129000,127000,128000,106725.609375,478990,127800,2000
"2019-09-06",128000,128500,126500,127500,106308.71875,380856,127675,2000
"2019-09-09",127500,128500,126000,127000,105891.8203125,378542,127400,2500
"2019-09-10",127000,128500,126500,128000,106725.609375,458487,127250,2000
"2019-09-11",128500,129000,127500,129000,107559.40625,756459,127250,1500
"2019-09-16",128500,129500,126000,128000,106725.609375,777956,127275,3500
"2019-09-17",127500,128000,125500,126000,105058.0234375,610086,127175,2500
"2019-09-18",126000,128500,125500,127500,106308.71875,537604,127150,3000
"2019-09-19",127500,129000,126500,129000,107559.40625,618746,127275,2500
"2019-09-20",128500,130500,128000,129500,107976.3046875,718752,127475,2500
"2019-09-23",129500,133500,129000,133000,110894.5703125,1007214,127925,4500
"2019-09-24",134000,135000,132000,134000,111728.375,615506,128325,3000
"2019-09-25",133000,135000,131500,134500,112145.28125,448004,128825,3500
"2019-09-26",136000,136500,132000,133000,110894.5703125,453068,129225,4500
"2019-09-27",134000,134000,131000,133500,111311.46875,348902,129525,3000
"2019-09-30",133500,135500,133000,134000,111728.375,429631,129900,2500
"2019-10-01",134000,134000,131500,132500,110477.671875,388512,130100,2500
"2019-10-02",131000,131500,128000,128500,107142.5,448012,129975,3500
"2019-10-04",129500,130000,126500,126500,105474.921875,488988,129875,3500
"2019-10-07",128000,129000,127000,128000,106725.609375,258951,129850,2000
"2019-10-08",128000,130500,127500,129500,107976.3046875,391115,129925,3000
"2019-10-10",127000,128000,125500,126500,105474.921875,771396,129875,2500
"2019-10-11",127000,127500,126000,126000,105058.0234375,369552,129825,1500
"2019-10-14",125000,126000,122000,122000,101722.84375,1260866,129525,4000
"2019-10-15",122000,123000,120500,122000,101722.84375,661262,129175,2500
"2019-10-16",123000,124000,122000,123000,102556.625,433874,128925,2000
"2019-10-17",123000,124500,122000,123000,102556.625,519468,128775,2500
"2019-10-18",123500,124500,122500,123000,102556.625,418395,128550,2000
"2019-10-21",124000,124000,122000,122000,101722.84375,372561,128200,2000
"2019-10-22",121500,122500,120000,122000,101722.84375,523445,127825,2500
"2019-10-23",121500,122500,120500,121000,100889.0546875,511570,127225,2000
"2019-10-24",121000,122500,120000,122000,101722.84375,655232,126625,2500
"2019-10-25",122000,124000,121500,123500,102973.546875,983777,126075,2500
"2019-10-28",124500,125000,121500,121500,101305.9453125,564300,125500,3500
"2019-10-29",122000,123000,121500,122500,102139.7265625,797389,124950,1500
"2019-10-30",122500,123000,121500,122500,102139.7265625,400285,124375,1500
"2019-10-31",122500,123500,121500,122000,101722.84375,441488,123850,2000
"2019-11-01",121500,124000,121000,124000,103390.4375,470554,123625,3000
"2019-11-04",123500,125000,123000,124000,103390.4375,475831,123500,2000
"2019-11-05",124000,125500,124000,125000,104224.2265625,471601,123350,1500
"2019-11-06",125500,126000,123500,123500,102973.546875,682414,123050,2500
"2019-11-07",123500,124500,123000,123500,102973.546875,853783,122900,1500
"2019-11-08",124000,124500,123500,124000,103390.4375,335809,122800,1000
"2019-11-11",124000,124500,123500,123500,102973.546875,370258,122875,1000
"2019-11-12",123500,125500,123500,125500,104641.1171875,598855,123050,2000
"2019-11-13",125000,126000,124500,124500,103807.3203125,528121,123125,1500
"2019-11-14",125000,125000,124000,124500,103807.3203125,540352,123200,1000
"2019-11-15",124500,125500,124000,125500,104641.1171875,469109,123325,1500
"2019-11-18",125000,126000,124500,126000,105058.0234375,596279,123525,1500
"2019-11-19",125000,126000,124500,125000,104224.2265625,537780,123675,1500
"2019-11-20",124500,124500,123500,124500,103807.3203125,593391,123850,1000
"2019-11-21",124000,124500,123000,124500,103807.3203125,724349,123975,1500
"2019-11-22",124000,125500,123500,123500,102973.546875,707333,123975,2000
"2019-11-25",124000,125500,123500,125000,104224.2265625,640837,124150,2000
"2019-11-26",124500,125500,122500,122500,102139.7265625,1854318,124150,3000
"2019-11-27",123000,124000,123000,123500,102973.546875,697261,124200,1000
"2019-11-28",123500,125000,123000,124000,103390.4375,742295,124300,2000
"2019-11-29",123500,124500,120000,121000,100889.0546875,1016506,124150,4500
"2019-12-02",121000,121500,118500,121500,101305.9453125,862135,124025,3000
"2019-12-03",120000,121500,119000,121500,101305.9453125,849994,123850,2500
"2019-12-04",120000,124000,120000,122000,101722.84375,1498918,123775,4000
"2019-12-05",121500,122500,117500,118000,98387.671875,1560647,123500,5000
"2019-12-06",118500,119500,118000,118500,98804.5625,1504634,123225,1500
"2019-12-09",119500,120500,119000,119500,99638.359375,902113,123025,1500
"2019-12-10",119500,120500,119000,120000,100055.25,784383,122750,1500
"2019-12-11",120500,120500,119000,119000,99221.4609375,1015977,122475,1500
"2019-12-12",119500,120500,119000,120000,100055.25,5201616,122250,1500
"2019-12-13",121500,122500,119500,121000,100889.0546875,1058172,122025,3000
"2019-12-16",120500,121000,119000,119000,99221.4609375,1015046,121675,2000
"2019-12-17",119500,123000,119000,122000,101722.84375,1904603,121525,4000
"2019-12-18",122000,123500,120500,123000,102556.625,1135407,121450,3000
"2019-12-19",122500,123500,122000,123500,102973.546875,905299,121400,1500
"2019-12-20",124000,124000,122500,124000,103390.4375,1001899,121425,1500
"2019-12-23",124000,125000,122000,122500,102139.7265625,1462906,121300,3000
"2019-12-24",123000,123000,121500,122000,101722.84375,600726,121275,1500
"2019-12-26",122500,123000,121500,122500,102139.7265625,552469,121225,1500
"2019-12-27",121000,121000,120000,120500,102994.4765625,422565,121050,1000
"2019-12-30",120500,121500,120000,120500,102994.4765625,467794,121025,1500
"2020-01-02",121000,121000,118000,118000,100857.65625,556532,120850,3000
"2020-01-03",118500,119000,115000,116000,99148.1953125,1145187,120575,4000
"2020-01-06",116000,117000,115500,116000,99148.1953125,334574,120275,1500
"2020-01-07",116500,117000,115500,115500,98720.8359375,674196,120150,1500
"2020-01-08",115000,115500,111500,112000,95729.2890625,1044825,119825,4000
"2020-01-09",113000,114500,110000,111500,95301.9296875,1375510,119425,4500
"2020-01-10",112500,114500,112000,113500,97011.390625,896507,119100,2500
"2020-01-13",113500,115500,113000,115000,98293.46875,692917,118900,2500
"2020-01-14",115500,117000,115500,116000,99148.1953125,739959,118700,1500
"2020-01-15",116000,116000,114000,115000,98293.46875,564142,118400,2000
"2020-01-16",117000,120000,116500,118500,101285.015625,1638719,118375,3500
"2020-01-17",118500,120000,118000,118500,101285.015625,574301,118200,2000
"2020-01-20",119500,119500,117500,118000,100857.65625,445922,117950,2000
"2020-01-21",118000,118500,116500,117000,100002.9375,545156,117625,2000
"2020-01-22",117500,127000,117500,127000,108550.1953125,2773421,117775,9500
"2020-01-23",130000,131500,128000,130500,111541.734375,2492785,118175,3500
"2020-01-28",127000,132500,127000,131000,111969.0859375,1841752,118625,5500
"2020-01-29",132000,133000,129000,131000,111969.0859375,1318578,119050,4000
"2020-01-30",130000,130500,126500,127500,108977.546875,1034661,119400,4000
"2020-01-31",128500,129500,124500,125000,106840.734375,1035126,119625,5000
"2020-02-03",123000,125000,121000,123500,105558.65625,1270442,119900,4000
"2020-02-04",123500,126000,122500,124000,105986.0234375,1203992,120300,3500
"2020-02-05",125000,126000,123500,124000,105986.0234375,1032267,120700,2500
"2020-02-06",125500,133000,125500,132000,112823.828125,1659774,121525,7500
"2020-02-07",130500,131000,127500,131000,111969.0859375,999598,122475,3500
"2020-02-10",129500,132000,129000,130000,111114.359375,669628,123400,3000
"2020-02-11",131000,135000,130500,132500,113251.1640625,949247,124350,4500
"2020-02-12",132500,137500,132500,136000,116242.7421875,1373302,125400,5000
"2020-02-13",137000,137500,133000,133000,113678.5390625,1035208,126250,4500
"2020-02-14",132500,135000,131500,133500,114105.90625,591584,127175,3500
"2020-02-17",133500,136000,132500,135500,115815.3515625,555451,128025,3500
"2020-02-18",134000,134500,131000,132500,113251.1640625,744150,128725,3500
"2020-02-19",133000,134000,130500,131500,112396.453125,776121,129400,3500
"2020-02-20",132500,133000,129000,130000,111114.359375,711858,130050,4000
"2020-02-21",128000,129500,127000,128000,109404.9140625,686417,130100,2500
"2020-02-24",124500,125000,122000,122500,104703.9140625,911932,129700,3000
"2020-02-25",122500,124500,122000,122500,104703.9140625,796176,129275,2500
"2020-02-26",121000,124000,120000,122500,104703.9140625,1001834,128850,4000
"2020-02-27",122500,123500,120000,121000,103421.8359375,779402,128525,3500
"2020-02-28",118500,119000,114000,115000,98293.46875,1777353,128025,5000
"2020-03-02",116000,116000,113000,113500,97011.390625,1183337,127525,3000
"2020-03-03",116000,116500,112000,112500,96156.671875,1414986,126950,4500
"2020-03-04",112000,114000,112000,113000,96584.0390625,1319901,126400,2000
"2020-03-05",115500,116000,113000,114000,97438.7578125,1135241,125500,3000
"2020-03-06",113000,113500,110000,110500,94447.2109375,1746834,124475,3500
"2020-03-09",110500,110500,110500,110500,94447.2109375,0,123500,0
"2020-03-10",102500,105000,101000,102000,87182.0390625,2491487,121975,4000
"2020-03-11",103000,103000,99700,1e+05,85472.59375,2005654,120175,3300
"2020-03-12",1e+05,1e+05,1e+05,1e+05,85472.59375,0,118525,0
"2020-03-13",86500,90200,83500,87200,74532.09375,4835445,116210,6700
"2020-03-16",88300,89500,82900,82900,70856.7890625,2674557,113580,6600
"2020-03-17",78100,83400,78100,80100,68463.53125,2492208,110960,5300
"2020-03-18",80500,81200,73500,73500,62822.35546875,2679420,108060,7700
"2020-03-19",75000,75900,65100,65900,56326.42578125,3138004,104855,10800
"2020-03-20",67500,72400,65000,71100,60771.0078125,3349914,102010,7400
"2020-03-23",67200,71000,66200,68900,58890.6171875,2391540,99330,4800
"2020-03-24",71500,75800,69800,74800,63933.49609375,2856282,96945,6000
"2020-03-25",79800,85600,78800,84500,72224.3359375,4604452,95045,6800
"2020-03-26",85800,90200,82300,84900,72566.2265625,3787074,93240,7900
"2020-03-27",89700,90000,84500,86400,73848.3203125,2513938,91810,5500
"2020-03-30",82800,86400,82100,85400,72993.6015625,1743720,90405,4300
"2020-03-31",87700,88700,86000,88700,75814.1953125,2138183,89215,2700
"2020-04-01",88500,90100,85300,85400,72993.6015625,2139848,87835,4800
"2020-04-02",85300,86800,83000,86600,74019.265625,1487243,86465,3800
"2020-04-03",86600,87000,85600,86300,73762.84375,1170052,85255,1400
"2020-04-06",86500,88800,85900,88800,75899.671875,1688599,84170,2900
"2020-04-07",92100,92500,88600,90400,77267.21875,2601711,83590,3900
"2020-04-08",89800,91900,88900,90000,76925.328125,1785939,83090,3000
"2020-04-09",92300,97900,91100,97100,82993.890625,3787201,82945,6800
"2020-04-10",97400,101500,96200,99700,85216.171875,2806785,83570,5300
"2020-04-13",98800,99000,97400,97800,83592.1875,1339638,84315,1600
"2020-04-14",98600,101500,97700,1e+05,85472.59375,1582587,85310,3800
"2020-04-16",98900,100500,98300,99100,84703.3359375,1341452,86590,2200
"2020-04-17",101000,103500,1e+05,100500,85899.953125,1487879,88320,3500
"2020-04-20",1e+05,100500,97100,97600,83421.2421875,2142176,89645,3400
"2020-04-21",96100,96500,91300,93500,79916.875,3634142,90875,5200
"2020-04-22",90800,95200,89400,92600,79147.6171875,3115871,91765,5800
"2020-04-23",93700,95100,92100,92400,78976.671875,3196313,92160,3000
"2020-04-24",91300,92300,90100,90100,77010.8046875,2135488,92420,2200
"2020-04-27",90300,92500,90200,91600,78292.890625,1219677,92680,2300
"2020-04-28",92500,94400,92200,93200,79660.453125,1448692,93070,2200
"2020-04-29",93500,94000,92400,93600,80002.34375,1193284,93315,1600
"2020-05-04",91100,92900,90700,91500,78207.4140625,1264378,93620,2200
"2020-05-06",93300,94200,92600,93200,79660.453125,1039600,93950,1600
"2020-05-07",92800,93000,91800,92600,79147.6171875,826239,94265,1200
"2020-05-08",93000,95400,93000,94500,80771.59375,1749677,94550,2400
"2020-05-11",95800,96500,93500,93700,80087.8125,1889278,94715,3000
"2020-05-12",93200,93800,91100,91900,78549.3046875,1259874,94810,2700
"2020-05-13",90500,93100,90500,93100,79574.9921875,966892,94610,2600
"2020-05-14",92600,92900,91500,92300,78891.1953125,982612,94240,1400
"2020-05-15",92000,92700,91200,92300,78891.1953125,822472,93965,1500
"2020-05-18",92100,92200,91000,91900,78549.3046875,741214,93560,1200
"2020-05-19",95000,99400,94700,99100,84703.3359375,4564370,93560,4700
"2020-05-20",98000,98300,96300,97300,83164.8203125,1828158,93400,2000
"2020-05-21",98600,98700,96600,97200,83079.359375,1471917,93380,2100
"2020-05-22",97100,97200,94000,94500,80771.59375,1619476,93430,3200
"2020-05-25",94900,96200,94000,96000,82053.6796875,1185541,93600,2200
"2020-05-26",96000,99500,95500,97800,83592.1875,2006216,93870,4000
"2020-05-27",98700,99500,97300,98100,83848.6171875,1620664,94270,2200
"2020-05-28",99500,99600,96200,97200,83079.359375,1602694,94550,3400
"2020-05-29",96300,99200,96300,98000,83763.1328125,2010414,94790,2900
"2020-06-01",98000,101500,98000,1e+05,85472.59375,1908428,95110,3500
"2020-06-02",99500,103000,98700,102500,87609.40625,2155405,95660,4300
"2020-06-03",106000,110000,105500,108500,92737.7578125,3118795,96425,4500
"2020-06-04",112000,113000,105000,108500,92737.7578125,2823041,97220,8000
"2020-06-05",108000,112000,106500,111000,94874.5703125,2128094,98045,5500
"2020-06-08",114000,114500,111500,113000,96584.0390625,1640392,99010,3000
"2020-06-09",114000,115000,110500,112000,95729.2890625,1504910,100015,4500
"2020-06-10",111000,112000,109000,111500,95301.9296875,1377837,100935,3000
"2020-06-11",110000,111000,107000,108500,92737.7578125,2376313,101745,4000
"2020-06-12",101500,105000,101500,103500,88464.1328125,1977558,102305,3500
"2020-06-15",102000,102500,97000,97000,82908.40625,2022775,102560,5500
"2020-06-16",99100,101500,99100,101500,86754.6875,1389765,102680,2400
"2020-06-17",100500,101000,98800,100500,85899.953125,1326645,102840,2200
"2020-06-18",99100,102000,98400,1e+05,85472.59375,1155455,102980,3600
"2020-06-19",101000,101500,99100,1e+05,85472.59375,903928,103255,2400
"2020-06-22",99100,1e+05,98500,98500,84190.5,921187,103380,1500
"2020-06-23",99200,101000,98000,98700,84361.4453125,1095698,103425,3000
"2020-06-24",1e+05,103500,99800,103000,88036.765625,1813817,103670,3700
"2020-06-25",100500,101000,99400,99400,84959.75,1084453,103780,1600
"2020-06-26",100500,101000,99500,1e+05,85472.59375,670161,103880,1500
"2020-06-29",97700,98700,97600,97700,83506.71875,943424,103765,1100
"2020-06-30",99100,99300,97700,97700,83506.71875,988987,103525,1600
"2020-07-01",98500,99500,98000,98200,83934.09375,640540,103010,1500
"2020-07-02",98000,99700,98000,99000,84617.8671875,730963,102535,1700
"2020-07-03",99900,100500,98600,99200,84788.8046875,569575,101945,1900
"2020-07-06",99700,102500,98800,101500,86754.6875,1189877,101370,3700
"2020-07-07",103000,103500,99200,99200,84788.8046875,1379122,100730,4300
"2020-07-08",99200,101000,99100,99600,85130.6953125,859735,100135,1900
"2020-07-09",1e+05,101000,99600,99600,85130.6953125,922604,99690,1400
"2020-07-10",99400,99500,98000,98300,84019.546875,1099298,99430,1500
"2020-07-13",99200,101500,98500,101500,86754.6875,1376002,99655,3000
"2020-07-14",101500,102000,99900,101500,86754.6875,1050563,99655,2100
"2020-07-15",104500,110000,104000,109000,93165.125,4494730,100080,6000
"2020-07-16",110500,113000,109000,110000,94019.8515625,3254530,100580,4000
"2020-07-17",109500,119000,109500,117500,100430.2890625,4265529,101455,9500
"2020-07-20",119500,125000,118000,121500,103849.1953125,4461527,102605,7000
"2020-07-21",122000,124500,118000,121500,103849.1953125,3138553,103745,6500
"2020-07-22",122000,124000,118500,118500,101285.015625,2395083,104520,5500
"2020-07-23",118500,125500,116000,124500,106413.375,4505464,105775,9500
"2020-07-24",123500,129000,121500,122500,104703.9140625,3908721,106900,7500
"2020-07-27",122500,126500,122000,123500,105558.65625,2046059,108190,4500
"2020-07-28",124500,126000,122000,123000,105131.28125,1765179,109455,4000
"2020-07-29",122500,125500,120000,125000,106840.734375,1897616,110795,5500
"2020-07-30",127000,130500,126000,127500,108977.546875,2728427,112220,4500
"2020-07-31",128000,129500,125000,126500,108122.828125,1712713,113585,4500
"2020-08-03",126500,128500,123500,127000,108550.1953125,1868315,114860,5000
"2020-08-04",129500,134000,129000,132500,113251.1640625,2492506,116525,5000
"2020-08-05",133000,135500,132000,134000,114533.2734375,1859551,118245,3500
"2020-08-06",136500,146000,136000,144500,123507.890625,4040334,120490,10000
"2020-08-07",145500,149500,144500,147000,125644.7109375,3208082,122925,5000
"2020-08-10",151500,172500,151000,170000,145303.390625,8460795,126350,21500
"2020-08-11",171500,180500,164500,179000,152995.96875,6776406,130225,16000
"2020-08-12",174000,178500,170500,172000,147012.859375,4877139,133375,8000
"2020-08-13",175000,177500,167000,170000,145303.390625,3997431,136375,10500
"2020-08-14",171000,172000,161000,167000,142739.1875,4469158,138850,11000
"2020-08-18",163500,168000,155500,158000,135046.703125,4328953,140675,12500
"2020-08-19",158000,165500,158000,164500,140602.421875,3298626,142825,7500
"2020-08-20",163000,165500,154000,155000,132482.515625,3630223,144650,11500
"2020-08-21",158000,161500,154000,156000,133337.21875,3348383,146225,7500
"2020-08-24",157500,163000,152500,161500,138038.21875,2904566,148175,10500
"2020-08-25",167500,171000,165000,166000,141884.484375,3304089,150300,6000
"2020-08-26",166500,170000,163000,167500,143166.59375,2638394,152525,7000
"2020-08-27",169000,169500,163500,163500,139747.671875,2427108,154450,6000
"2020-08-28",165500,176500,164500,172000,147012.859375,5571784,156675,12000
"2020-08-31",177500,182000,174500,176500,150859.125,5275614,159175,7500
"2020-09-01",178500,181000,175500,180000,153850.65625,2704194,161825,5500
"2020-09-02",178000,178500,173500,176000,150431.765625,2825239,164000,5000
"2020-09-03",177500,177500,174000,176500,150859.125,1841550,166125,3500
"2020-09-04",167500,174000,167500,172500,147440.21875,2886867,167525,6500
"2020-09-07",172500,173000,169000,170000,145303.390625,1516649,168675,4000
"2020-09-08",171000,172500,168000,168000,143593.9375,1933504,168575,4500
"2020-09-09",166500,172000,165500,167500,143166.59375,1685225,168000,6500
"2020-09-10",170500,171500,168000,169000,144448.671875,1326177,167850,3500
"2020-09-11",167500,171500,167500,171500,146585.5,1538378,167925,4000
"2020-09-14",174500,180000,174000,180000,153850.65625,3145262,168575,6000
"2020-09-15",184000,185000,178500,179000,152995.96875,2644009,169625,6500
"2020-09-16",179500,186000,177000,183500,156842.1875,3401835,170575,9000
"2020-09-17",185500,191500,183000,184000,157269.578125,4383978,172025,8500
"2020-09-18",184000,186000,179000,181000,154705.34375,2584103,173275,7000
"2020-09-21",181000,188500,180500,185000,158124.296875,3133848,174450,8000
"2020-09-22",185000,186000,178000,179500,153423.296875,3042046,175125,8000
"2020-09-23",183000,183000,170000,179500,153423.296875,3481682,175725,13000
"2020-09-24",173500,176000,171000,171500,146585.5,2841908,176125,5000
"2020-09-25",172500,174000,166000,170000,145303.390625,2076987,176025,8000
"2020-09-28",173000,176000,172000,175500,150004.375,1374871,175975,4000
"2020-09-29",178500,180000,177500,178500,152568.609375,1475249,175900,2500
"2020-10-05",183000,187500,181500,187000,159833.75,2732820,176450,6000
"2020-10-06",188000,188500,181500,182500,155987.46875,2143171,176750,7000
"2020-10-07",180000,183500,178500,183000,156414.828125,1512423,177275,5000
"2020-10-08",185500,186000,180000,180500,154278.015625,1750474,177800,6000
"2020-10-12",178000,181500,176000,180000,153850.65625,1655359,178400,5500
"2020-10-13",181000,181500,176000,179000,152995.96875,1728432,178975,5500
"2020-10-14",181000,183500,177000,178000,152141.203125,1930046,179425,6500
"2020-10-15",177000,178500,175000,176000,150431.765625,1587551,179650,3500
"2020-10-16",176500,177500,169000,172000,147012.859375,3197258,179250,8500
"2020-10-19",169500,172000,167500,168000,143593.9375,2230634,178700,4500
"2020-10-20",157000,168500,156500,167500,143166.59375,5697398,177900,12000
"2020-10-21",167000,167500,163500,165500,141457.140625,1760669,176975,4000
"2020-10-22",163000,163500,161000,162500,138892.953125,1700524,176050,2500
"2020-10-23",163500,168000,163000,167000,142739.1875,1883932,175150,5000
"2020-10-26",167000,174000,164000,171500,146585.5,3018359,174750,10000
"2020-10-27",173000,178000,171000,172500,147440.21875,3317704,174400,7000
"2020-10-28",172000,174000,169500,173500,148294.96875,1419988,174500,4500
"2020-10-29",169000,171000,168000,170000,145303.390625,1484537,174500,3000
"2020-10-30",169000,169500,164500,164500,140602.421875,1452259,173950,5000
"2020-11-02",166000,170500,166000,170500,145730.734375,1052301,173550,4500
"2020-11-03",171000,172000,169000,170500,145730.734375,1006364,172725,3000
"2020-11-04",173000,175000,170500,171500,146585.5,1699252,172175,4500
"2020-11-05",173500,175000,172500,175000,149577.03125,1299430,171775,2500
"2020-11-06",176500,177000,169500,170500,145730.734375,2233192,171275,7500
"2020-11-09",172500,174500,172000,172500,147440.21875,1521010,170900,2500
"2020-11-10",174500,174500,172000,173500,148294.96875,1796342,170625,2500
"2020-11-11",174500,179000,173000,175500,150004.375,4140745,170500,6000
"2020-11-12",175500,177000,173000,174000,148722.3125,1965154,170400,4000
"2020-11-13",174000,178500,173500,177500,151713.84375,2405777,170675,5000
"2020-11-16",182500,183500,177500,179000,152995.96875,2752922,171225,6000
"2020-11-17",179500,185000,178000,182500,155987.46875,3429139,171975,7000
"2020-11-18",183500,185500,179000,179500,153423.296875,2228657,172675,6500
"2020-11-19",179000,181500,177500,180000,153850.65625,1379907,173550,4000
"2020-11-20",179000,179500,177000,177000,151286.46875,1309560,174050,2500
"2020-11-23",175000,179500,175000,179000,152995.96875,1494870,174425,4500
"2020-11-24",181000,183000,179500,181000,154705.34375,1522580,174850,3500
"2020-11-25",183500,184000,178000,179500,153423.296875,2082764,175150,6000
"2020-11-26",179500,181000,178000,179000,152995.96875,1260429,175600,3000
"2020-11-27",179000,181000,178000,181000,154705.34375,1033868,176425,3000
"2020-11-30",181500,188500,181500,181500,155132.765625,3981271,176975,7000
"2020-12-01",183000,184500,179500,183500,156842.1875,1792800,177625,5000
"2020-12-02",183500,184500,181500,182500,155987.46875,1745795,178175,3000
"2020-12-03",183500,196500,182000,196500,167953.640625,6053809,179250,14500
"2020-12-04",198000,199000,195000,196500,167953.640625,3224702,180550,4000
"2020-12-07",195500,198500,190500,193500,165389.46875,2519339,181600,8000
"2020-12-08",191000,192000,186000,186500,159406.390625,3181249,182250,6000
"2020-12-09",188000,192000,187000,191500,163680.015625,1805987,183050,5000
"2020-12-10",189000,194000,188000,191500,163680.015625,2187019,183925,6000
"2020-12-11",193000,194500,190000,190000,162397.921875,1644559,184550,4500
"2020-12-14",190500,191000,187000,189000,161543.1875,1259459,185050,4000
"2020-12-15",189000,190500,186000,188500,161115.8125,1355388,185350,4500
"2020-12-16",190000,193500,189500,190000,162397.921875,1268117,185875,4000
"2020-12-17",190000,190500,188000,190500,162825.296875,974859,186400,2500
"2020-12-18",191000,191000,189000,189000,161543.1875,930831,187000,2000
"2020-12-21",188500,189000,185000,187000,159833.75,1120752,187400,4000
"2020-12-22",186000,186500,183000,184000,157269.578125,1381697,187550,3500
"2020-12-23",183000,188500,183000,185000,158124.296875,1301433,187825,5500
"2020-12-24",185000,189000,185000,187000,159833.75,1061140,188225,4000
"2020-12-28",189000,193000,187500,189500,161970.578125,2410348,188650,5500
"2020-12-29",191000,191500,188000,190500,165444.4375,1488327,189100,3500
"2020-12-30",190500,193500,189000,192000,166747.15625,1361340,189525,4500
"2021-01-04",194000,211000,193500,207500,180208.53125,5651695,190775,17500
"2021-01-05",207000,213000,205000,209500,181945.46875,3022595,191425,8000
"2021-01-06",209500,211500,202500,203000,176300.421875,2848547,191750,9000
"2021-01-07",206000,210500,204500,206000,178905.8125,2478337,192375,6000
"2021-01-08",240500,257000,225000,246000,213644.796875,19933702,195350,32000
"2021-01-11",256500,289000,256000,267500,232317.015625,14433887,199150,33000
"2021-01-12",263500,274500,250500,261000,226671.921875,8040182,202625,24000
"2021-01-13",259500,265000,250000,259000,224934.96875,5805649,206075,15000
"2021-01-14",251000,255500,248500,250500,217552.96875,3389733,209150,7000
"2021-01-15",252000,255000,239000,240000,208433.96875,3915078,211725,16000
"2021-01-18",237500,246500,234000,241000,209302.421875,3387635,214275,12500
"2021-01-19",244000,261500,244000,261500,227106.15625,4976690,217825,17500
"2021-01-20",271000,277000,254000,259000,224934.96875,5305494,221325,23000
"2021-01-21",264000,266500,259500,264500,229711.609375,2593509,225200,7000
"2021-01-22",261000,263000,257000,257000,223198.03125,2093127,228850,6000
"2021-01-25",253000,262000,251500,260000,225803.453125,1895263,232600,10500
"2021-01-26",260500,260500,250500,251500,218421.40625,1846817,235825,10000
"2021-01-27",252000,254500,245000,245500,213210.578125,2190994,238625,9500
"2021-01-28",238000,243500,236500,238500,207131.25,2033262,241025,7000
"2021-01-29",242000,242500,227000,229000,198880.71875,2663404,242875,15500
"2021-02-01",229000,238500,224500,238500,207131.25,1798912,244425,14000
"2021-02-02",241500,243500,236000,240500,208868.203125,1519973,245975,7500
"2021-02-03",245000,252500,242500,245500,213210.578125,2983093,248100,10000
"2021-02-04",251500,253000,244000,248500,215815.96875,1907305,250225,9000
"2021-02-05",249500,250500,243000,249500,216684.484375,1539977,250400,7500
"2021-02-08",238000,240500,228500,234000,203223.109375,3212977,248725,12000
"2021-02-09",232500,240500,232500,236500,205394.3125,1391614,247500,8000
"2021-02-10",239000,246000,235000,245000,212776.3125,1233628,246800,11000
"2021-02-15",247000,249000,243500,247500,214947.5,916331,246650,5500
"2021-02-16",249000,251000,245000,247500,214947.5,1179084,247025,6000
"2021-02-17",248000,248000,242500,243500,211473.609375,871176,247150,5500
"2021-02-18",241000,243500,235500,235500,204525.84375,1260023,245850,8000
"2021-02-19",236500,242000,235500,242000,210170.890625,1168454,245000,6500
"2021-02-22",243000,247500,240000,241500,209736.640625,1157808,243850,7500
"2021-02-23",242500,247500,237000,244500,212342.09375,1629578,243225,10500
"2021-02-24",246500,249000,235000,235000,204091.59375,2072507,241975,14000
"2021-02-25",239000,245000,235000,245000,212776.3125,1562697,241650,10000
"2021-02-26",238500,248500,235500,237000,205828.53125,2710962,241225,13000
"2021-03-02",244500,249000,237000,239000,207565.484375,2509152,241250,12000
"2021-03-03",239000,241500,236500,240000,208433.96875,910872,241800,5000
"2021-03-04",236000,238000,232500,235000,204091.59375,1274581,241625,5500
"2021-03-05",230500,237000,228500,235000,204091.59375,1153198,241350,8500
"2021-03-08",237000,237500,230000,230500,200183.484375,853206,240600,7500
"2021-03-09",230500,234000,228000,231500,201051.921875,1254755,239750,6000
"2021-03-10",236500,236500,227000,227500,197578.03125,901351,238650,9500
"2021-03-11",228000,232000,227500,228500,198446.484375,1154314,238375,4500
"2021-03-12",231500,233500,229000,232500,201920.390625,823038,238175,4500
"2021-03-15",233000,236000,230000,232000,201486.140625,769672,237525,6000
"2021-03-16",233500,235000,232000,234000,203223.109375,633617,236850,3000
"2021-03-17",234000,234000,230000,232000,201486.140625,627439,236075,4000
"2021-03-18",234500,238000,233500,234000,203223.109375,1005422,235600,4500
"2021-03-19",230000,232000,229000,229500,199314.96875,1055587,235300,3000
"2021-03-22",230000,231000,227500,229000,198880.71875,739527,234650,3500
"2021-03-23",229500,231000,225500,226500,196709.546875,1024811,233900,5500
"2021-03-24",225000,225500,220000,221000,191932.921875,1049551,232725,5500
"2021-03-25",218500,220500,216000,218000,189327.515625,1087519,231875,4500
"2021-03-26",219500,219500,212000,215500,187156.328125,1480861,230400,7500
"2021-03-29",215500,217500,211000,215500,187156.328125,1184415,229325,6500
"2021-03-30",215500,221000,215000,219500,190630.21875,935840,228350,6000
"2021-03-31",221500,222000,218000,218000,189327.515625,750876,227250,4000
"2021-04-01",220500,224500,218500,219000,190195.96875,749450,226450,6000
"2021-04-02",225500,238500,225000,233500,202788.859375,3648528,226375,13500
"2021-04-05",236000,236500,230000,234000,203223.109375,990184,226550,6500
"2021-04-06",235000,235000,229500,230000,199749.21875,737694,226475,5500
"2021-04-07",228500,232500,226500,230000,199749.21875,708886,226600,6000
"2021-04-08",229000,233500,227000,231500,201051.921875,915323,226750,6500
"2021-04-09",231500,232000,227000,228500,198446.484375,726250,226550,5000
"2021-04-12",228000,229000,225500,226000,196275.3125,659014,226250,3500
"2021-04-13",226500,230000,226000,230000,199749.21875,634607,226050,4000
"2021-04-14",231000,237000,230500,232500,201920.390625,940909,226075,6500
"2021-04-15",232500,232500,229000,230500,200183.484375,555364,225900,3500
"2021-04-16",231500,233500,230500,231500,201051.921875,577562,226000,3000
"2021-04-19",232000,232500,229000,230000,199749.21875,715867,226050,3500
"2021-04-20",230000,231000,228500,229000,198880.71875,722449,226175,2500
"2021-04-21",227500,228000,224000,225500,195841.078125,848076,226400,4000
"2021-04-22",226500,231000,225500,226000,196275.3125,1025922,226800,5500
"2021-04-23",225500,225500,220500,221000,191932.921875,1202196,227075,5000
"2021-04-26",221500,222500,220000,221500,192367.171875,653982,227375,2500
"2021-04-27",222000,222500,218000,220000,191064.453125,763634,227400,4500
"2021-04-28",220000,223500,219500,221500,192367.171875,701452,227575,4000
"2021-04-29",221000,221500,217000,217500,188893.25,1047837,227500,4500
"2021-04-30",216000,216500,211000,212000,184116.671875,1168115,226425,5500
"2021-05-03",212000,222500,211000,218000,189327.515625,1189242,225625,11500
"2021-05-04",220000,224500,217500,223500,194104.109375,953550,225300,7000
"2021-05-06",223000,225000,221000,223500,194104.109375,645594,224975,4000
"2021-05-07",223500,227000,221000,224000,194538.34375,639489,224600,6000
"2021-05-10",226500,230000,225500,229500,199314.96875,1117219,224650,4500
"2021-05-11",227000,228500,223500,226500,196709.546875,852825,224675,5000
"2021-05-12",226500,233000,223000,227500,197578.03125,1649500,224550,10000
"2021-05-13",224000,232000,221500,229500,199314.96875,1593554,224400,10500
"2021-05-14",234000,236000,226500,229000,198880.71875,1357407,224325,9500
"2021-05-17",232000,232500,225000,227000,197143.765625,875528,224100,7500
"2021-05-18",227500,232500,226000,231000,200617.671875,1034501,224150,6500
"2021-05-20",228500,230500,224000,224500,194972.578125,1190072,223925,6500
"2021-05-21",227000,233000,225500,227500,197578.03125,1333704,224025,7500
"2021-05-24",227500,231000,226000,228000,198012.265625,765657,224125,5000
"2021-05-25",230000,230000,225000,227500,197578.03125,781950,224450,5000
"2021-05-26",227500,229000,222500,223500,194104.109375,1088210,224550,6500
"2021-05-27",223000,223500,220000,220500,191498.703125,2306997,224575,3500
"2021-05-28",223500,232500,223000,232000,201486.140625,2394356,225100,9500
"2021-05-31",233000,235500,230500,235000,204091.59375,1132711,225975,5000
"2021-06-01",235000,237500,232500,237000,205828.53125,1027141,227225,5000
"2021-06-02",238500,243000,235500,238000,206697.015625,1707167,228225,7500
"2021-06-03",238500,240500,236500,238500,207131.25,1034103,228975,4000
"2021-06-04",241500,243000,238000,241500,209736.640625,1333789,229875,5000
"2021-06-07",244500,247500,240500,241500,209736.640625,1343895,230750,7000
"2021-06-08",241500,245000,238500,243500,211473.609375,875362,231450,6500
"2021-06-09",243000,245500,239000,239500,207999.734375,941037,232100,6500
"2021-06-10",239000,240000,236000,236000,204960.078125,1094346,232525,4000
"2021-06-11",237500,241500,237000,238500,207131.25,687536,232975,4500
"2021-06-14",238500,240000,235000,238000,206697.015625,561560,233425,5000
"2021-06-15",238000,239000,235500,237000,205828.53125,471192,233925,3500
"2021-06-16",237000,243000,237000,239500,207999.734375,778322,234350,6000
"2021-06-17",239000,239500,236000,236500,205394.3125,724881,234950,3500
"2021-06-18",237000,238000,235000,235000,204091.59375,1036077,235325,3000
"2021-06-21",234000,236000,232000,233000,202354.671875,823355,235575,4000
"2021-06-22",235500,243000,235000,241000,209302.421875,1299242,236250,8000
"2021-06-23",242000,243000,239000,242500,210605.125,843399,237200,4000
"2021-06-24",243500,249000,241000,242500,210605.125,1494131,238300,8000
"2021-06-25",243500,244000,241000,243000,211039.390625,537893,238850,3000
"2021-06-28",244000,244500,240000,241000,209302.421875,575102,239150,4500
"2021-06-29",240500,242500,239000,239500,208866.40625,627915,239275,3500
"2021-06-30",240000,241000,238500,239500,208866.40625,653096,239350,2500
"2021-07-01",238500,243000,236000,242000,211046.609375,1031692,239525,7000
"2021-07-02",243500,243500,239000,239000,208430.34375,829518,239400,4500
"2021-07-05",239000,240000,235000,236000,205814.078125,861912,239125,5000
"2021-07-06",236500,238000,235500,236000,205814.078125,497009,238750,2500
"2021-07-07",235000,235500,232000,232000,202325.671875,1122107,238375,3500
"2021-07-08",232000,233000,229000,229500,200145.453125,1241792,238050,4000
"2021-07-09",227500,229000,225000,226000,197093.125,1137429,237425,4000
"2021-07-12",229000,232000,228000,230000,200581.5,529258,237025,4000
"2021-07-13",230000,231500,229000,230000,200581.5,518563,236675,2500
"2021-07-14",230500,232500,228500,230000,200581.5,582990,236200,4000
"2021-07-15",230000,232500,229500,231500,201889.640625,546166,235950,3000
"2021-07-16",230000,230500,228000,230000,200581.5,468595,235700,2500
"2021-07-19",228000,228500,227000,227500,198401.265625,432339,235425,1500
"2021-07-20",225500,229500,225000,227000,197965.203125,636495,234725,4500
"2021-07-21",231500,232000,227500,228000,198837.3125,631902,234000,4500
"2021-07-22",228500,231500,227500,228500,199273.34375,790428,233300,4000
"2021-07-23",229000,229000,224000,225500,196657.078125,1574776,232425,5000
"2021-07-26",225500,226500,224000,224500,195784.96875,719330,231600,2500
"2021-07-27",225500,226500,224000,225000,196221.046875,738143,230875,2500
"2021-07-28",225000,225000,221000,222500,194040.796875,886854,230025,4000
"2021-07-29",223000,224000,222000,222000,193604.75,496679,229025,2000
"2021-07-30",222000,222000,218000,218000,190116.375,909716,227975,4000
"2021-08-02",218000,220500,217000,220000,191860.5625,676544,227175,3500
"2021-08-03",219000,223500,218000,223500,194912.875,775231,226550,5500
"2021-08-04",224000,225000,222500,225000,196221.046875,542319,226200,2500
"2021-08-05",223000,224500,222500,223000,194476.84375,470741,225875,2000
"2021-08-06",224500,225000,222500,222500,194040.796875,384056,225700,2500
"2021-08-09",220500,222500,220000,221000,192732.640625,582236,225250,2500
"2021-08-10",220500,221000,218500,219000,190988.453125,497715,224700,2500
"2021-08-11",219000,220500,218000,218500,190552.390625,490442,224125,2500
"2021-08-12",220000,224000,219000,219000,190988.453125,862826,223500,5000
"2021-08-13",221500,221500,214000,217000,189244.28125,864375,222850,7500
"2021-08-17",216000,217000,211000,213000,185755.921875,863610,222125,6000
"2021-08-18",211000,214000,209000,212500,185319.859375,671920,221400,5000
"2021-08-19",212500,212500,205000,206500,180087.296875,1180734,220325,7500
"2021-08-20",207000,208000,2e+05,201500,175726.828125,1310974,218975,8000
"2021-08-23",203000,206000,201500,204000,177907.0625,848219,217900,4500
"2021-08-24",206000,211000,206000,209500,182703.578125,745430,217150,5000
"2021-08-25",210000,212500,207500,209500,182703.578125,477019,216375,5000
"2021-08-26",209500,212000,208000,210000,183139.625,417323,215750,4000
"2021-08-27",209000,209500,205000,208500,181831.484375,502218,215075,4500
"2021-08-30",211000,212500,210000,210000,183139.625,409963,214675,2500
"2021-08-31",210000,212500,208000,212500,185319.859375,777103,214300,4500
"2021-09-01",214000,218500,213500,215000,187500.09375,855937,213875,5000
"2021-09-02",214000,215000,210000,211500,184447.78125,656283,213200,5000
"2021-09-03",213000,215500,212000,214500,187064.0625,739961,212775,3500
"2021-09-06",214500,216000,213500,215000,187500.09375,389587,212400,2500
"2021-09-07",214500,214500,211500,212500,185319.859375,434105,211975,3000
"2021-09-08",210500,214500,210000,213000,185755.921875,593084,211675,4500
"2021-09-09",212500,212500,208000,208500,181831.484375,780270,211175,4500
"2021-09-10",208500,209500,204000,206500,180087.296875,678308,210550,5500
"2021-09-13",206500,206500,204000,205000,178779.15625,590609,209950,2500
"2021-09-14",206500,211500,206000,209000,182267.53125,721080,209750,5500
"2021-09-15",208000,211500,208000,209500,182703.578125,472855,209600,3500
"2021-09-16",210000,211000,206500,208000,181395.4375,416275,209675,4500
"2021-09-17",208000,210000,207000,209000,182267.53125,698398,210050,3000
"2021-09-23",205000,209000,204500,208500,181831.484375,525020,210275,4500
"2021-09-24",209500,210500,206000,207000,180523.359375,413926,210150,4500
"2021-09-27",205000,206000,203500,204000,177907.0625,584898,209875,2500
"2021-09-28",204000,204000,200500,201500,175726.828125,719631,209450,3500
"2021-09-29",197500,202000,197500,201500,175726.828125,934463,209100,4500
"2021-09-30",2e+05,201000,199000,2e+05,174418.6875,594666,208600,2000
"2021-10-01",198000,199000,192000,193500,168750.09375,1182422,207650,7000
"2021-10-05",191000,195000,189000,193500,168750.09375,1056472,206575,6000
"2021-10-06",195000,197500,192500,194000,169186.125,913916,205700,5000
"2021-10-07",194500,203000,194500,201000,175290.765625,1066226,205025,8500
"2021-10-08",203500,206500,202500,205000,178779.15625,993219,204525,4000
"2021-10-12",205000,206500,202000,204500,178343.109375,820163,204125,4500
"2021-10-13",206500,211500,206500,211000,184011.71875,1169924,204025,5000
"2021-10-14",211500,212000,208000,209000,182267.53125,863110,204050,4000
"2021-10-15",210500,211500,208000,208500,181831.484375,530328,204150,3500
"2021-10-18",208000,210500,205000,209500,182703.578125,607227,204375,5500
"2021-10-19",210500,212000,208000,209000,182267.53125,428739,204375,4000
"2021-10-20",210000,211000,208000,209000,182267.53125,472664,204350,3000
"2021-10-21",209500,211000,206000,207500,180959.40625,775441,204325,5000
"2021-10-22",207000,209500,206000,207500,180959.40625,362676,204250,3500
"2021-10-25",207500,212000,206000,211000,184011.71875,649860,204375,6000
"2021-10-26",213000,214500,209000,213500,186191.9375,782736,204700,5500
"2021-10-27",214500,215000,212500,213500,186191.9375,606729,205175,2500
"2021-10-28",213000,214000,209500,210000,183139.625,633732,205600,4500
"2021-10-29",211500,212500,206500,208000,181395.4375,667275,205925,6000
"2021-11-01",208000,209500,207000,208000,181395.4375,395091,206325,2500
"2021-11-02",208000,211500,207500,210000,183139.625,417645,207150,4000
"2021-11-03",211000,212000,207000,208500,181831.484375,476081,207900,5000
"2021-11-04",211000,216000,210000,214000,186628.015625,1122870,208900,6000
"2021-11-05",216500,217000,214000,215000,187500.09375,686779,209600,3000
"2021-11-08",214500,216500,212500,215000,187500.09375,532328,210100,4000
"2021-11-09",216000,217000,212000,213000,185755.921875,620316,210525,5000
"2021-11-10",211000,211500,206500,208500,181831.484375,680033,210400,5000
"2021-11-11",205500,206500,203500,205000,178779.15625,710080,210200,3000
"2021-11-12",205000,209500,205000,208000,181395.4375,415172,210175,4500
"2021-11-15",208000,210000,207000,209000,182267.53125,377424,210150,3000
"2021-11-16",208000,208000,205000,206500,180087.296875,515194,210025,3000
"2021-11-17",206500,209000,203000,207000,180523.359375,715192,209925,6000
"2021-11-18",205500,206500,204000,205000,178779.15625,562783,209800,2500
"2021-11-19",211500,212500,208000,209500,182703.578125,829314,209900,4500
"2021-11-22",209500,220000,207500,218500,190552.390625,1620439,210275,12500
"2021-11-23",219000,219500,213500,215000,187500.09375,818782,210350,6000
"2021-11-24",215500,216000,211000,212000,184883.828125,652274,210275,5000
"2021-11-25",212500,212500,210000,210000,183139.625,414037,210275,2500
"2021-11-26",209500,210000,204000,205500,179215.203125,901184,210150,6000
"2021-11-29",199500,203500,199500,200500,174854.765625,901640,209775,4000
"2021-11-30",202000,203500,194500,195500,170494.28125,1313581,209050,9000
"2021-12-01",198500,202000,196500,201000,175290.765625,741594,208675,5500
"2021-12-02",198500,206000,198000,205500,179215.203125,782923,208250,8000
"2021-12-03",205500,208000,204500,206000,179651.25,514358,207800,3500
"2021-12-06",204500,208000,202500,206500,180087.296875,503652,207375,5500
"2021-12-07",206000,208000,204000,207500,180959.40625,501624,207100,4000
"2021-12-08",210000,211000,207000,207500,180959.40625,502904,207050,4000
"2021-12-09",207000,210000,206500,207000,180523.359375,775215,207150,3500
"2021-12-10",207000,209500,205500,207500,180959.40625,443350,207125,4000
"2021-12-13",210000,214000,209000,209000,182267.53125,877690,207125,5000
"2021-12-14",208000,212000,207500,211000,184011.71875,499536,207350,4500
"2021-12-15",210500,211500,208500,209000,182267.53125,436219,207450,3000
"2021-12-16",211500,212000,208000,209500,182703.578125,457620,207675,4000
"2021-12-17",208500,211500,208000,209500,182703.578125,623863,207675,3500
"2021-12-20",209000,209500,204500,205000,178779.15625,542620,207000,5000
"2021-12-21",206000,207500,204000,205000,178779.15625,548609,206500,3500
"2021-12-22",207000,209500,205500,206500,180087.296875,480545,206225,4000
"2021-12-23",208000,209000,207000,209000,182267.53125,372738,206175,2000
"2021-12-24",210500,216500,210500,215500,187936.140625,1024355,206675,6000
"2021-12-27",216500,217000,213500,213500,186191.9375,530039,207325,3500
"2021-12-28",215000,215000,211500,214000,186628.015625,880326,208250,3500
"2021-12-29",213000,215000,211500,212000,188405.4375,659392,208800,3500
"2021-12-30",211500,212000,208500,209000,185739.265625,581448,208975,3500
"2022-01-04",212500,212500,208500,210000,186628.015625,499857,209175,4000
"2022-01-05",214000,217500,212000,213500,189738.453125,1175411,209525,5500
"2022-01-06",210000,216500,210000,214000,190182.8125,866582,209850,6500
"2022-01-07",214500,216500,213500,215000,191071.546875,577852,210225,3000
"2022-01-10",214000,215000,209000,209500,186183.671875,744261,210350,6000
"2022-01-11",209500,211500,209000,210500,187072.359375,482235,210500,2500
"2022-01-12",211500,213000,210500,211500,187961.0625,470451,210625,2500
"2022-01-13",211500,213000,210000,210000,186628.015625,499094,210575,3000
"2022-01-14",209500,211000,208000,209000,185739.265625,406569,210575,3000
"2022-01-17",208500,209000,202500,205000,182184.484375,724213,210350,6500
"2022-01-18",206000,206000,201500,202500,179962.734375,580959,210000,4500
"2022-01-19",200500,203500,2e+05,200500,178185.328125,525014,209775,3500
"2022-01-20",200500,202500,199500,202000,179518.375,451581,209625,3000
"2022-01-21",199500,201000,198500,2e+05,177740.953125,513891,209300,2500
"2022-01-24",197500,2e+05,195000,197000,175074.859375,659010,208700,5000
"2022-01-25",196500,197000,190000,194500,172853.078125,1174185,207650,7000
"2022-01-26",194500,194500,194500,194500,172853.078125,0,206700,0
"2022-01-27",190000,191500,185500,186500,165743.453125,1072651,205325,6000
"2022-01-28",186500,186500,186500,186500,165743.453125,0,204050,0
"2022-02-03",193000,195500,191500,191500,170186.984375,837241,203175,4000
"2022-02-04",190500,192000,188000,190000,168853.921875,837609,202175,4000
"2022-02-07",189500,190000,184500,186500,165743.453125,829365,200825,5500
"2022-02-08",186500,186500,186500,186500,165743.453125,0,199450,0
"2022-02-09",186500,186500,186500,186500,165743.453125,0,198025,0
"2022-02-10",186000,187000,182500,185500,164854.71875,1280607,196825,4500
"2022-02-11",183000,184500,181000,183000,162632.984375,1001635,195450,3500
"2022-02-14",179500,181000,176000,176500,156856.390625,1380176,193700,5000
"2022-02-15",177000,183000,176500,180500,160411.203125,961742,192225,6500
"2022-02-16",184500,185500,181000,182000,161744.28125,561867,190875,4500
"2022-02-17",183000,186000,181000,183500,163077.328125,767679,189800,5000
"2022-02-18",181000,184000,180500,183500,163077.328125,426090,188850,3500
"2022-02-21",183500,183500,183500,183500,163077.328125,0,188000,0
"2022-02-22",183500,183500,183500,183500,163077.328125,0,187075,0
"2022-02-23",183500,183500,183500,183500,163077.328125,0,186250,0
"2022-02-24",178500,179000,171000,173000,153745.921875,1722526,185050,8000
"2022-02-25",175000,175500,171500,174000,154634.640625,949885,184025,4000
"2022-02-28",174000,174000,174000,174000,154634.640625,0,183000,0
"2022-03-02",171500,172500,169500,170500,151524.140625,1384049,182200,3000
"2022-03-03",173500,179000,173000,177500,157745.078125,1244300,181750,6000
"2022-03-04",177500,177500,177500,177500,157745.078125,0,181050,0
"2022-03-07",170000,171000,165500,168000,149302.390625,1439259,179950,5500
"2022-03-08",164000,170500,163500,168000,149302.390625,728464,179025,7000
"2022-03-10",168000,168000,168000,168000,149302.390625,0,178100,0
"2022-03-11",168000,168000,168000,168000,149302.390625,0,177175,0
"2022-03-14",166500,167500,163000,164500,146191.953125,1112790,176125,4500
"2022-03-15",164500,164500,164500,164500,146191.953125,0,175200,0
"2022-03-16",164500,164500,164500,164500,146191.953125,0,174600,0
"2022-03-17",164500,164500,164500,164500,146191.953125,0,173800,0
"2022-03-18",171500,171500,169500,171000,151968.53125,782119,173250,2000
"2022-03-21",171000,171000,171000,171000,151968.53125,0,172625,0
"2022-03-22",169000,174500,169000,173500,154190.296875,1166430,172125,5500
"2022-03-23",175000,177500,174000,176000,156412.046875,952954,171750,3500
"2022-03-24",174000,177000,173500,176000,156412.046875,709518,171375,3500
"2022-03-25",176500,176500,173000,174000,154634.640625,563456,170900,3500
"2022-03-28",172000,175500,171000,174500,155078.96875,459678,170975,4500
"2022-03-29",176000,178000,174000,176500,156856.390625,545335,171100,4000
"2022-03-30",180000,183000,179500,181000,160855.5625,1082135,171450,3500
"2022-03-31",180500,181000,179000,180500,160411.203125,576522,171950,2000
"2022-04-01",178000,178500,177000,178000,158189.4375,470770,171975,1500
"2022-04-04",177000,179000,174500,178000,158189.4375,509106,172000,4500
"2022-04-05",178500,180000,177000,179000,159078.1875,426072,172550,3000
"2022-04-06",177000,182000,176500,180000,159966.84375,641803,173150,5500
"2022-04-07",180000,182000,178500,178500,158633.828125,778374,173675,3500
"2022-04-08",178000,179000,175500,176500,156856.390625,458780,174100,3500
"2022-04-11",176000,181000,175500,179500,159522.515625,641674,174850,5500
"2022-04-12",179000,180500,176500,178000,158189.4375,626266,175525,4000
"2022-04-13",179500,181000,178500,181000,160855.5625,498547,176350,2500
"2022-04-14",181000,182000,176500,177500,157745.078125,898024,177000,5500
"2022-04-15",176500,178000,175500,177000,157300.734375,559522,177300,2500
"2022-04-18",176000,178500,175500,178500,158633.828125,275773,177675,3000
"2022-04-19",178500,181500,178000,181000,160855.5625,623880,178050,3500
"2022-04-20",181000,184000,180000,183000,162632.984375,814107,178400,4000
"2022-04-21",184000,184500,182500,183000,162632.984375,657116,178750,2000
"2022-04-22",181500,182500,179000,180000,159966.84375,852781,179050,3500
"2022-04-25",177000,184500,176500,182000,161744.28125,1504197,179425,8000
"2022-04-26",187000,191000,186500,187000,166187.796875,2313611,179950,4500
"2022-04-27",184000,188500,183000,187000,166187.796875,1152068,180250,5500
"2022-04-28",188000,189000,186000,188500,167520.859375,705457,180650,3000
"2022-04-29",187000,188000,184000,186000,165299.078125,767005,181050,4000
"2022-05-02",184000,188000,184000,187000,166187.796875,496083,181500,4000
"2022-05-03",185500,186500,182500,183500,163077.328125,662535,181725,4000
"2022-05-04",183500,184500,182000,184000,163521.6875,347996,181925,2500
"2022-05-06",181500,183500,181000,182500,162188.625,375723,182125,2500
"2022-05-10",180500,181500,176000,180500,160411.203125,774377,182325,5500
"2022-05-11",178500,184500,178000,183000,162632.984375,724251,182500,6500
"2022-05-12",181000,183500,180000,180500,160411.203125,691192,182625,3500
"2022-05-13",182000,187000,181500,186500,165743.453125,924029,182900,5500
"2022-05-16",188500,189500,183500,184000,163521.6875,548683,183225,6000
"2022-05-17",185500,186500,182500,185500,164854.71875,530263,183650,4000
"2022-05-18",187000,187500,183500,185500,164854.71875,541137,184000,4000
"2022-05-19",181500,183500,181000,182000,161744.28125,542030,184050,2500
"2022-05-20",183500,186500,183000,186500,165743.453125,469517,184225,3500
"2022-05-23",188500,189000,186500,188000,167076.484375,436270,184475,2500
"2022-05-24",187000,188000,183500,185000,164410.375,431231,184725,4500
"2022-05-25",186000,186000,182000,183500,163077.328125,482136,184800,4000
"2022-05-26",183500,186000,183000,184000,163521.6875,428541,184650,3000
"2022-05-27",186500,186500,184500,185500,164854.71875,334939,184575,2000
"2022-05-30",187500,188000,185500,187500,166632.140625,368902,184525,2500
"2022-05-31",187000,189500,187000,189500,168409.546875,916327,184700,2500
"2022-06-02",189000,189000,186500,187500,166632.140625,387758,184725,2500
"2022-06-03",188500,189000,185000,187000,166187.796875,400003,184900,4000
"2022-06-07",186000,186500,183000,183500,163077.328125,621262,184875,3500
"2022-06-08",183500,185000,182000,183000,162632.984375,556940,184900,3000
"2022-06-09",183000,183500,180500,182500,162188.625,656175,185000,3000
"2022-06-10",181500,185000,180500,184500,163966.03125,571131,185075,4500
"2022-06-13",180000,181500,173000,175000,155523.328125,1193167,184800,8500
"2022-06-14",171500,172500,169000,171500,152412.875,1122467,184050,3500
"2022-06-15",173500,179000,171500,174000,154634.640625,995832,183550,7500
"2022-06-16",177000,177500,172500,173000,153745.921875,619047,182925,5000
"2022-06-17",168000,172000,168000,170000,151079.8125,784685,182150,4000
"2022-06-20",172500,173000,168500,170500,151524.140625,518566,181575,4500
"2022-06-21",171500,175000,170000,172500,153301.578125,532008,180875,5000
"2022-06-22",174500,175000,171000,171500,152412.875,633838,180050,4000
"2022-06-23",171500,174000,170000,171000,151968.53125,807430,179350,4000
"2022-06-24",170500,175000,170500,173000,153745.921875,472975,178825,4500
"2022-06-27",177000,185000,176500,183000,162632.984375,1348957,178775,8500
"2022-06-28",183500,189000,183500,186000,165299.078125,1021549,178800,5500
"2022-06-29",180000,181000,172500,175500,156810.734375,2543120,178200,8500
"2022-06-30",176500,184500,175500,180500,161278.296875,1651221,177750,9000
"2022-07-01",181500,185000,179500,180000,160831.53125,916020,177375,5500
"2022-07-04",181000,183000,175000,178000,159044.515625,1006440,176925,8000
"2022-07-05",180000,181000,173500,177500,158597.75,1097504,176625,7500
"2022-07-06",176000,177000,172000,172500,154130.234375,924184,176100,5000
"2022-07-07",175000,177000,172500,175000,156364,536363,175725,4500
"2022-07-08",177500,180500,177000,178000,159044.515625,824702,175400,3500
"2022-07-11",180000,182000,179000,179000,159938.0625,660814,175600,3000
"2022-07-12",180000,181500,177000,179000,159938.0625,539027,175975,4500
"2022-07-13",180000,185000,178500,183500,163958.828125,941277,176450,6500
"2022-07-14",183000,184500,180500,182500,163065.3125,780637,176925,4000
"2022-07-15",183000,184500,178500,183500,163958.828125,768143,177600,6000
"2022-07-18",187000,188500,183500,185500,165745.828125,699961,178350,5000
"2022-07-19",185000,189000,184500,188500,168426.375,868892,179150,4500
"2022-07-20",191500,191500,188500,189000,168873.125,985986,180025,3000
"2022-07-21",189000,193500,185500,189000,168873.125,2136819,180925,8000
"2022-07-22",191000,193000,188000,191000,170660.125,1378005,181825,5000
"2022-07-25",192500,198500,192500,196000,175127.65625,1352264,182475,6000
"2022-07-26",196000,196500,192500,196000,175127.65625,735482,182975,4000
"2022-07-27",196000,197000,193000,196000,175127.65625,608998,184000,4000
"2022-07-28",198000,198000,194000,195000,174234.15625,757504,184725,4000
"2022-07-29",196000,197000,194000,196000,175127.65625,844829,185525,3000
"2022-08-01",196000,198000,195000,196000,175127.65625,601112,186425,3000
"2022-08-02",196500,197000,193500,196500,175574.453125,721088,187375,3500
"2022-08-03",197000,198000,196000,197000,176021.203125,683572,188600,2000
"2022-08-04",198000,198500,194500,196500,175574.453125,622111,189675,4000
"2022-08-05",196000,197500,193500,194500,173787.421875,919482,190500,4000
"2022-08-08",193500,196000,193000,196000,175127.65625,635689,191350,3000
"2022-08-09",195500,196000,191000,193500,172893.90625,962838,192075,5000
"2022-08-10",193000,194500,192000,192500,172000.40625,510243,192525,2500
"2022-08-11",195000,195000,192500,193000,172447.15625,731121,193050,2500
"2022-08-12",193500,197500,193500,196000,175127.65625,627417,193675,4000
"2022-08-16",198000,199500,196000,197500,176467.9375,505801,194275,3500
"2022-08-17",195000,196500,188000,190000,169766.640625,1410422,194350,8500
"2022-08-18",186500,187500,184000,186000,166192.578125,1438270,194200,3500
"2022-08-19",187000,191500,186500,190000,169766.640625,770986,194250,5000
"2022-08-22",187500,192000,187000,189000,168873.125,532730,194150,5000
"2022-08-23",189000,193000,188000,189000,168873.125,711974,193800,5000
"2022-08-24",190000,191000,185500,188000,167979.59375,700265,193400,5500
"2022-08-25",189000,192500,188500,192000,171553.65625,561737,193200,4000
"2022-08-26",192500,194000,191500,193500,172893.90625,473581,193125,2500
"2022-08-29",188500,189000,186500,188500,168426.375,601747,192750,2500
"2022-08-30",190500,196000,190500,195500,174680.921875,891335,192725,5500
"2022-08-31",195000,197500,194500,196000,175127.65625,762426,192700,3000
"2022-09-01",193500,197500,191000,195500,174680.921875,785337,192625,6500
"2022-09-02",199000,203500,196000,196500,175574.453125,1401989,192625,7500
"2022-09-05",197500,201000,197500,2e+05,178701.71875,886938,192900,3500
"2022-09-06",200500,201000,198000,201000,179595.21875,591596,193150,3000
"2022-09-07",201000,203000,199000,202000,180488.75,758254,193575,4000
"2022-09-08",202500,203000,198500,2e+05,178701.71875,860563,193950,4500
"2022-09-13",200500,201500,198000,200500,179148.484375,910285,194325,3500
"2022-09-14",197000,2e+05,196000,198500,177361.421875,668955,194450,4000
"2022-09-15",199000,201000,198000,198000,176914.703125,404656,194475,3000
"2022-09-16",199500,202500,199000,201000,179595.21875,911954,195025,3500
"2022-09-19",201500,202000,198000,201500,180041.96875,693456,195800,4000
"2022-09-20",202500,202500,198500,198500,177361.421875,692217,196225,4000
"2022-09-21",197000,197500,194500,197000,176021.203125,622478,196625,3000
"2022-09-22",194500,197000,192500,193500,172893.90625,540322,196850,4500
"2022-09-23",194000,195500,190500,190500,170213.375,680644,196975,5000
"2022-09-26",187000,187500,180500,182500,163065.3125,1609911,196500,7000
"2022-09-27",182500,186000,182000,186000,166192.578125,890612,196125,4000
"2022-09-28",184000,184500,177500,179500,160384.796875,1163914,195675,7000
"2022-09-29",182500,184000,181000,181500,162171.8125,714142,194975,3000
"2022-09-30",181000,183000,174000,176500,157704.265625,1005125,194000,9000
"2022-10-04",179000,183000,177500,179500,160384.796875,831935,193200,5500
"2022-10-05",183500,184000,172000,177000,158151.015625,1144019,192225,12000
"2022-10-06",178500,179500,175000,178000,159044.515625,611007,191125,4500
"2022-10-07",176500,176500,174000,175500,156810.734375,608384,189850,2500
"2022-10-11",170000,170500,166000,168000,150109.4375,1145441,188150,4500
"2022-10-12",166500,169500,165500,168000,150109.4375,821753,186550,4000
"2022-10-13",167500,168000,164500,164500,146982.171875,691537,184750,3500
"2022-10-14",167000,168000,165000,167000,149215.921875,657249,183175,3000
"2022-10-17",166000,168500,164000,167000,149215.921875,665601,181625,4500
"2022-10-18",170500,171500,165000,168000,150109.4375,1286984,179975,6500
"2022-10-19",166000,172500,166000,168000,150109.4375,1111330,178300,6500
"2022-10-20",168500,169500,166500,168500,150556.21875,692203,176800,3000
"2022-10-21",169000,169500,165500,167000,149215.921875,695788,175300,4000
"2022-10-24",169000,169500,161500,161500,144301.640625,1443569,173700,8000
"2022-10-25",162500,163000,160000,162500,145195.125,967860,172300,3000
"2022-10-26",163000,164000,160000,160500,143408.140625,1023919,171200,4000
"2022-10-27",161000,163500,160500,162000,144748.390625,876823,170000,3000
"2022-10-28",162000,166000,161500,164000,146535.40625,752111,169225,4500
"2022-10-31",166000,166500,162000,164500,146982.171875,622380,168375,4500
"2022-11-01",163500,165000,162000,164500,146982.171875,628185,167775,3000
"2022-11-02",164500,165000,162000,165000,147428.890625,941434,167050,3000
"2022-11-03",162500,163000,160500,162000,144748.390625,1008989,166300,2500
"2022-11-04",162000,164000,161500,163000,145641.90625,522276,165550,2500
"2022-11-07",166500,170000,165500,169500,151449.71875,1126417,165250,4500
"2022-11-08",171500,172000,167500,170000,151896.453125,804889,165350,4500
"2022-11-09",170500,172000,167000,169500,151449.71875,953568,165425,5000
"2022-11-10",167000,173000,166500,169500,151449.71875,1018720,165675,6500
"2022-11-11",174500,175500,171000,172000,153683.46875,980474,165925,4500
"2022-11-14",174500,179500,174000,176000,157257.515625,1379189,166375,5500
"2022-11-15",176500,177000,173000,174500,155917.234375,838806,166700,4000
"2022-11-16",175000,175500,170500,172000,153683.46875,642717,166900,5000
"2022-11-17",171000,172500,169500,170000,151896.453125,502812,166975,3000
"2022-11-18",170000,173000,169500,169500,151449.71875,559141,167100,3500
"2022-11-21",169500,170000,166500,168000,150109.4375,517728,167425,3500
"2022-11-22",167500,168000,165000,165500,147875.65625,454542,167575,3000
"2022-11-23",166500,167500,164000,166000,148322.421875,449446,167850,3500
"2022-11-24",168000,168500,166500,167500,149662.671875,323362,168125,2000
"2022-11-25",168000,168500,166000,166000,148322.421875,356637,168225,2500
"2022-11-28",166000,169500,164000,167500,149662.671875,551024,168375,5500
"2022-11-29",168000,169500,167000,169000,151002.96875,341427,168600,2500
"2022-11-30",169000,170500,168500,169000,151002.96875,633720,168800,2000
"2022-12-01",172000,173000,170500,171500,153236.734375,499538,169275,2500
"2022-12-02",172000,172500,168500,169000,151002.96875,453689,169575,4000
"2022-12-05",169500,170000,164500,165500,147875.65625,788455,169375,5500
"2022-12-06",164000,165000,162500,164500,146982.171875,434862,169100,2500
"2022-12-07",163500,165000,163000,163000,145641.90625,379112,168775,2000
"2022-12-08",163500,163500,161000,162000,144748.390625,703551,168400,2500
"2022-12-09",163500,164000,162000,162500,145195.125,464194,167925,2000
"2022-12-12",162000,163500,162000,163500,146088.65625,232963,167300,1500
"2022-12-13",164000,164000,158000,159500,142514.625,756323,166550,6000
"2022-12-14",160000,165000,159500,163500,146088.65625,614474,166125,5500
"2022-12-15",162500,165000,162000,162000,144748.390625,383741,165725,3000
"2022-12-16",160000,163000,160000,162500,145195.125,446581,165375,3000
"2022-12-19",160500,161500,157500,159000,142067.875,734465,164925,4000
"2022-12-20",158000,158500,154500,157000,140280.828125,1039931,164500,4000
"2022-12-21",157000,157500,155500,156000,139387.34375,531850,164000,2000
"2022-12-22",156500,159500,156500,158500,141621.125,452454,163550,3000
"2022-12-23",157000,158000,155500,157000,140280.828125,336597,163100,2500
"2022-12-26",157000,159000,157000,158000,141174.375,387872,162625,2000
"2022-12-27",158500,160000,157000,158000,141174.375,637139,162075,3000
"2022-12-28",156000,156500,154000,154000,143031.921875,556921,161325,2500
"2022-12-29",153000,154000,150500,151000,140245.578125,552974,160300,3500
"2023-01-02",154000,161000,154000,157000,145818.234375,1132256,159700,7000
"2023-01-03",158500,160500,156000,159000,147675.796875,787752,159375,4500
"2023-01-04",157500,161000,157500,160500,149068.984375,463444,159175,3500
"2023-01-05",161000,161500,158000,159000,147675.796875,577152,158975,3500
"2023-01-06",157500,161500,157500,159500,148140.203125,502420,158850,4000
"2023-01-09",161000,164500,160000,164000,152319.6875,614204,158925,4500
"2023-01-10",162500,164000,161500,163000,151390.921875,414613,158900,2500
"2023-01-11",163500,165000,163000,164000,152319.6875,367725,159125,2000
"2023-01-12",166000,168000,164500,166500,154641.625,869403,159275,3500
"2023-01-13",167500,170000,167000,169000,156963.609375,707095,159625,3000
"2023-01-16",166500,167500,163500,166500,154641.625,797353,159825,4000
"2023-01-17",166500,167000,164500,166000,154177.234375,452113,160175,2500
"2023-01-18",166500,166500,162500,164500,152784.109375,499603,160550,4000
"2023-01-19",162000,164000,162000,164000,152319.6875,353522,160950,2000
"2023-01-20",163000,164500,163000,164500,152784.109375,296063,161250,1500
"2023-01-25",166100,166500,165200,165700,153898.625,2088,161685,1300
"2023-01-26",166600,176200,166600,175100,162629.140625,14251,162540,9600
"2023-01-27",177000,177600,173300,173900,161514.609375,4005,163335,4300
"2023-01-30",174400,175700,169400,173900,161514.609375,3624,164330,6300
"2023-01-31",169000,170400,167000,170000,157892.359375,5408,165280,3400
"2023-02-01",169200,171500,168700,167000,155106.03125,3251,165780,2800
"2023-02-02",171500,172900,169300,169900,157799.484375,3621,166325,3600
"2023-02-03",170100,174500,169600,169900,157799.484375,3940,166795,4900
"2023-02-06",174000,174700,170700,172800,160492.953125,1700,167485,4000
"2023-02-07",171000,171200,169500,170500,158356.75,2221,168035,1700
"2023-02-08",171500,173000,170200,170500,158356.75,1223,168360,2800
"2023-02-09",171900,174000,171500,172600,160307.1875,3503,168840,2500
"2023-02-10",171600,173500,171100,173200,160864.453125,1670,169300,2400
"2023-02-13",172700,174300,171300,171600,159378.4375,3230,169555,3000
"2023-02-14",172900,175700,172700,173700,161328.859375,1429,169790,3000
"2023-02-15",174600,175300,171800,172700,160400.078125,937,170100,3500
"2023-02-16",173400,180000,173300,179300,166530.015625,3219,170765,6700
"2023-02-17",177400,179800,177000,179000,166251.375,1647,171490,2800
"2023-02-20",179400,179400,176600,178200,165508.359375,1245,172200,2800
"2023-02-21",178500,179000,175500,178200,165508.359375,2722,172885,3500
"2023-02-22",175800,176900,174000,174200,161793.234375,3595,173310,2900
"2023-02-23",174400,178600,174300,176200,163650.796875,3418,173365,4300
"2023-02-24",176200,177300,173800,173900,161514.609375,1925,173365,3500
"2023-02-27",173100,173600,170200,173300,160957.359375,427027,173335,3400
"2023-02-28",174100,178100,174000,176300,163743.671875,824763,173650,4100
"2023-03-02",176500,179800,176500,178500,165787.015625,747929,174225,3300
"2023-03-03",177500,178200,175000,176100,163557.921875,549203,174535,3200
"2023-03-06",177800,178500,176000,177500,164858.203125,547005,174915,2500
"2023-03-07",176500,177500,175100,175100,162629.140625,462996,175030,2400
"2023-03-08",174300,176100,174100,174900,162443.390625,497195,175250,2000
"2023-03-09",176600,180400,175700,176300,163743.671875,808110,175540,4700
"2023-03-10",174700,176700,174600,175000,162536.234375,443221,175660,2100
"2023-03-13",174400,176300,173500,176000,163465.03125,529759,175800,2800
"2023-03-14",175200,175900,170500,171000,158821.140625,589581,175770,5400
"2023-03-15",172700,175500,172700,174300,161886.109375,481716,175800,2800
"2023-03-16",172800,174800,171800,174000,161607.484375,392030,175865,3000
"2023-03-17",175200,176600,173200,176600,164022.3125,507745,175730,3400
"2023-03-20",176500,177000,174800,175100,162629.140625,366357,175535,2200
"2023-03-21",175900,176900,174800,175800,163279.28125,297779,175415,2100
"2023-03-22",177000,180500,176700,180300,167458.78125,718542,175520,3800
"2023-03-23",179300,182400,178700,180500,167644.53125,591091,175835,3700
"2023-03-24",180600,180600,175300,177700,165043.96875,649952,175910,5300
"2023-03-27",177700,177700,174800,176100,163557.921875,402749,176020,2900
"2023-03-28",177100,178300,175800,177100,164486.71875,341408,176210,2500
"2023-03-29",175800,180700,175800,180400,167551.65625,571771,176415,4900
"2023-03-30",179200,181900,178800,181200,168294.671875,525981,176550,3100
"2023-03-31",182000,184900,181900,184500,171359.640625,668373,176970,3000
"2023-04-03",184600,185500,182300,183600,170523.765625,534323,177275,3200
"2023-04-04",184000,186500,183300,183800,170709.5,510739,177710,3200
"2023-04-05",185100,187200,184000,186700,173402.96875,509578,178300,3200
"2023-04-06",186900,189400,184700,185100,171916.921875,667512,178740,4700
"2023-04-07",185400,186500,184600,185100,171916.921875,435717,179245,1900
"2023-04-10",186000,188500,184200,185900,172659.9375,480371,179740,4300
"2023-04-11",186600,192400,185100,192100,178418.375,1067237,180795,7300
"2023-04-12",195000,199500,194600,198200,184083.921875,1517626,181990,4900
"2023-04-13",199000,199900,196200,198900,184734.078125,824006,183235,3700
"2023-04-14",199500,199700,196000,196100,182133.5,670548,184210,3700
"2023-04-17",195400,196100,193800,195000,181111.84375,497443,185205,2300
"2023-04-18",192700,193000,188200,191400,177768.21875,961739,185985,4800
"2023-04-19",191400,194200,190300,193600,179811.53125,571094,186650,3900
"2023-04-20",193000,194100,191400,192500,178789.875,423616,187250,2700
"2023-04-21",191100,191800,188300,190400,176839.453125,454248,187885,3500
"2023-04-24",190600,193100,190600,191900,178232.640625,434584,188675,2500
"2023-04-25",193000,201500,191200,201000,186684.5,2084924,189870,10300
"2023-04-26",205500,207500,199900,201500,187148.890625,2214068,190925,7600
"2023-04-27",201500,205000,200500,202000,187613.28125,976414,191965,4500
"2023-04-28",203000,203500,196200,197500,183433.78125,1056770,192615,7300
"2023-05-02",198500,202000,197700,201500,187148.890625,573959,193510,4300
"2023-05-03",200500,202000,198500,201000,186684.5,460771,194370,3500
"2023-05-04",2e+05,201000,197400,199200,185012.71875,472704,194995,3600
"2023-05-08",201000,203000,2e+05,202500,188077.671875,590557,195865,3000
"2023-05-09",202000,205500,199900,205000,190399.625,704155,196860,5600
"2023-05-10",206000,211000,205000,210000,195043.515625,1476327,198065,6000
"2023-05-11",211500,211500,208000,208000,193185.953125,919476,198860,3500
"2023-05-12",207000,209500,205500,208500,193650.328125,539737,199375,4000
"2023-05-15",207000,209000,204000,208000,193185.953125,594282,199830,5000
"2023-05-16",206500,207500,201000,202500,188077.671875,874247,200150,6500
"2023-05-17",202500,205500,202500,204500,189935.234375,550297,200625,3000
"2023-05-18",207000,207000,205000,206500,191792.78125,476896,201380,2000
"2023-05-19",206000,207500,204000,205500,190864.015625,528680,201975,3500
"2023-05-22",206000,208500,204500,207500,192721.578125,469209,202725,4000
"2023-05-23",209000,209000,207000,207500,192721.578125,356438,203580,2000
"2023-05-24",206000,208000,205500,207500,192721.578125,305061,204360,2500
"2023-05-25",206000,206500,203000,203500,189006.453125,528730,204485,3500
"2023-05-26",204500,205500,201000,205500,190864.015625,596247,204685,4500
"2023-05-30",207000,207000,2e+05,200500,186220.125,861994,204610,7000
"2023-05-31",200500,203000,2e+05,2e+05,185755.734375,879887,204735,3000
"2023-06-01",199800,199800,196300,197500,183433.78125,791585,204535,3500
"2023-06-02",198500,199800,198100,199500,185291.328125,418613,204460,1700
"2023-06-05",201500,203500,2e+05,201000,186684.5,454150,204550,3500
"2023-06-07",202500,203000,195400,196400,182412.125,960900,204245,7600
"2023-06-08",195500,197200,194000,196700,182690.75,928559,203830,3200
"2023-06-09",197400,198300,196300,197100,183062.25,421616,203185,2000
"2023-06-12",197500,198500,195100,196200,182226.359375,429448,202595,3400
"2023-06-13",196700,198200,196200,198000,183898.171875,474628,202070,2000
"2023-06-14",198800,201500,198500,201000,186684.5,662184,201720,3000
"2023-06-15",201500,202000,199400,199700,185477.09375,354685,201580,2600
"2023-06-16",201000,201500,198000,199400,185198.46875,548562,201325,3500
"2023-06-19",198000,199400,197000,199300,185105.59375,375749,200965,2400
"2023-06-20",198300,199000,197000,197900,183805.296875,331277,200585,2000
"2023-06-21",197900,205000,196300,204000,189470.828125,1028131,200410,8700
"2023-06-22",202500,203500,200500,202000,187613.28125,392056,200135,3000
"2023-06-23",201000,202000,199000,199900,185662.859375,349362,199755,3000
"2023-06-26",199900,202500,199900,200500,186220.125,307090,199605,2600
"2023-06-27",201000,206000,201000,206000,191328.390625,806971,199630,5000
"2023-06-28",206000,206500,203000,206000,191328.390625,630872,199905,3500
"2023-06-29",205500,206000,204000,204500,191328.390625,320058,200130,2000
"2023-06-30",204500,209000,204500,206500,193199.59375,563079,200580,4500
"2023-07-03",207500,208500,205500,208500,195070.765625,545516,201030,3000
"2023-07-04",208500,210000,206500,208000,194602.953125,424908,201380,3500
"2023-07-05",208000,209500,204500,205500,192263.984375,586067,201835,5000
"2023-07-06",204000,208500,204000,206500,193199.59375,643771,202325,4500
"2023-07-07",205500,206000,202500,204000,190860.59375,476427,202670,3500
"2023-07-10",205000,208000,202000,205500,192263.984375,511222,203135,6000
"2023-07-11",206500,208000,205000,207000,193667.375,538193,203585,3000
"2023-07-12",206000,206500,202500,203500,190392.796875,503118,203710,4000
"2023-07-13",205000,205000,203000,203500,190392.796875,540814,203900,2000
"2023-07-14",204500,209000,204500,208500,195070.765625,655619,204355,4500
"2023-07-17",207000,208500,203500,203500,190392.796875,517107,204565,5000
"2023-07-18",204000,205000,201000,201500,188521.625,501091,204745,4000
"2023-07-19",201500,203500,2e+05,202000,188989.421875,491509,204645,3500
"2023-07-20",202000,204000,2e+05,200500,187586.03125,531811,204570,4000
"2023-07-21",199700,201000,198200,2e+05,187118.25,508793,204575,2800
"2023-07-24",199100,200500,197600,199200,186369.78125,614300,204510,2900
"2023-07-25",199900,202500,199200,200500,187586.03125,492019,204235,3300
"2023-07-26",201000,202000,195000,198700,185901.953125,1347123,203870,7000
"2023-07-27",202500,203000,194000,197800,185059.921875,1244827,203535,9000
"2023-07-28",196500,201500,196500,196800,184124.359375,782058,203050,5000
"2023-07-31",198000,198200,195100,196000,183375.875,678535,202425,3100
"2023-08-01",195200,199600,194600,199400,186556.890625,698965,201995,5000
"2023-08-02",197800,198800,192400,192500,180101.296875,917045,201345,6400
"2023-08-03",192500,194300,190800,191700,179352.828125,531818,200605,3500
"2023-08-04",191600,193400,190500,192200,179820.625,378998,200015,2900
"2023-08-07",191000,191100,187300,188000,175891.140625,842043,199140,3800
"2023-08-08",188000,190500,187700,188400,176265.375,557129,198210,2800
"2023-08-09",188400,189800,187500,189400,177200.984375,366474,197505,2300
"2023-08-10",189000,190300,188100,188400,176265.375,489856,196750,2200
"2023-08-11",188900,193200,188400,190500,178230.109375,529916,195850,4800
"2023-08-14",190000,190500,188300,188800,176639.609375,297138,195115,2200
"2023-08-16",186900,188100,185300,185800,173832.84375,563291,194330,2800
"2023-08-17",184900,185500,182600,184800,172897.25,458036,193470,2900
"2023-08-18",182600,187500,182600,186100,174113.515625,420787,192750,4900
"2023-08-21",187000,187200,185300,186100,174113.515625,279766,192055,1900
"2023-08-22",186200,187900,186200,187900,175797.578125,297596,191490,1700
"2023-08-23",186500,188700,186000,187500,175423.34375,252159,190840,2700
"2023-08-24",188300,189300,186000,186400,174394.203125,320108,190225,3300
"2023-08-25",184200,187000,184200,186200,174207.0625,368503,189645,2800
"2023-08-28",186200,186900,184700,185400,173458.609375,300125,189075,2200
"2023-08-29",185500,188200,185400,186700,174674.875,321448,188610,2800
"2023-08-30",188600,189300,187800,187800,175704,331121,188030,1500
"2023-08-31",187800,189100,186200,189100,176920.296875,590270,187860,2900
"2023-09-01",188000,188900,186700,187400,175329.796875,281460,187645,2200
"2023-09-04",186400,187400,185600,187300,175236.234375,307475,187400,1800
"2023-09-05",186500,186900,185600,186600,174581.328125,290618,187330,1300
"2023-09-06",186000,188300,186000,186700,174674.875,259552,187245,2300
"2023-09-07",185500,187200,185400,187200,175142.65625,299030,187135,1800
"2023-09-08",187500,187500,185200,185700,173739.28125,192047,187000,2300
"2023-09-11",185700,186300,184400,185500,173552.15625,195283,186750,1900
"2023-09-12",186500,188400,185600,186200,174207.0625,273908,186620,2800
"2023-09-13",187300,190700,187200,189800,177575.203125,579550,186820,3500
"2023-09-14",191200,191200,188600,190700,178417.21875,627998,187115,2600
"2023-09-15",190700,192700,189100,192200,179820.625,526604,187420,3600
"2023-09-18",191200,192200,190200,191000,178697.90625,289943,187665,2000
"2023-09-19",191500,193200,190000,190000,177762.328125,289352,187770,3200
"2023-09-20",190600,196000,190000,194900,182346.734375,636780,188140,6000
"2023-09-21",194400,194500,191600,191900,179539.9375,327599,188415,2900
"2023-09-22",189600,192400,189200,191500,179165.703125,326229,188680,3200
"2023-09-25",191700,193500,189600,192900,180475.546875,346374,189055,3900
"2023-09-26",191600,192900,189900,190700,179815.484375,302642,189255,3000
"2023-09-27",189200,192400,189000,191100,180192.65625,367983,189420,3400
"2023-10-04",188000,193200,187100,190800,179909.78125,641075,189505,6100
"2023-10-05",190900,192200,189500,190500,179626.890625,396264,189660,2700
"2023-10-06",191000,192600,189600,192200,181229.859375,345787,189905,3000
"2023-10-10",192700,192800,187700,188400,177646.765625,575373,189995,5100
"2023-10-11",189000,191400,189000,189400,178589.703125,490998,190130,2400
"2023-10-12",189600,189800,187700,188000,177269.59375,451893,190170,2100
"2023-10-13",187500,188400,187100,187100,176420.953125,254250,190240,1300
"2023-10-16",186900,188300,186500,186800,176138.078125,291429,190305,1800
"2023-10-17",188300,189300,187100,188500,177741.046875,423633,190420,2200
"2023-10-18",190400,193000,189500,191800,180852.703125,532948,190520,3500
"2023-10-19",189900,190800,188800,188900,178118.234375,408555,190430,2000
"2023-10-20",187800,188600,183500,183500,173026.4375,602367,189995,5100
"2023-10-23",184200,186100,183800,185400,174818,286602,189715,2300
"2023-10-24",186900,187000,181400,182800,172366.40625,418638,189355,5600
"2023-10-25",182700,183700,182000,182000,171612.046875,374888,188710,1700
"2023-10-26",180300,182500,178500,179500,169254.734375,651245,188090,4000
"2023-10-27",181200,182900,174600,175600,165577.34375,787539,187295,8300
"2023-10-30",175000,176300,171400,172500,162654.28125,726773,186275,4900
"2023-10-31",174300,175900,169300,169700,160014.109375,697296,185225,6600
"2023-11-01",170800,171500,169400,170300,160579.84375,450423,184185,2100
"2023-11-02",172000,175100,171500,172000,162182.8125,661435,183245,3600
"2023-11-03",175000,175400,172700,173400,163502.921875,431491,182390,2700
"2023-11-06",175400,177900,174900,177900,167746.0625,661383,181675,3000
"2023-11-07",177500,177500,174200,176100,166048.8125,532443,181060,3300
"2023-11-08",177900,179000,174500,174800,164823,395162,180330,4500
"2023-11-09",174700,175700,174200,174700,164728.71875,384071,179665,1500
"2023-11-10",173800,175300,173500,173700,163785.796875,255065,178995,1800
"2023-11-13",175000,175000,172800,173300,163408.625,348523,178320,2200
"2023-11-14",174900,175900,173900,175200,165200.1875,329429,177655,2000
"2023-11-15",178700,182600,178600,182500,172083.515625,806741,177190,4000
"2023-11-16",182500,186400,181800,184800,174252.234375,432174,176985,4600
"2023-11-17",185900,185900,183500,184400,173875.078125,259919,177030,2400
"2023-11-20",184400,184900,182100,183600,173120.71875,277906,176940,2800
"2023-11-21",184700,184800,183500,184200,173686.5,252833,177010,1300
"2023-11-22",182300,183400,181200,183000,172554.96875,219027,177060,2200
"2023-11-23",183600,185000,182400,184800,174252.234375,240354,177325,2600
"2023-11-24",184600,185600,183900,184000,173497.90625,161656,177745,1700
"2023-11-27",184000,185700,184000,184900,174346.53125,188306,178365,1700
"2023-11-28",185900,185900,183600,185700,175100.859375,269820,179165,2300
"2023-11-29",185700,186500,184700,184800,174252.234375,298485,179890,1800
"2023-11-30",184200,184900,182100,184300,173780.78125,574490,180505,2800
"2023-12-01",183300,183800,181700,182800,172366.40625,304309,180975,2100
"2023-12-04",183900,184100,181600,181600,171234.890625,378913,181160,2500
"2023-12-05",181600,182000,180700,181400,171046.28125,275980,181425,1300
"2023-12-06",181100,183400,181100,182900,172460.671875,280528,181830,2300
"2023-12-07",181400,183300,181400,182600,172177.796875,296154,182225,1900
"2023-12-08",183600,185700,183400,185100,174535.109375,327749,182795,2300
"2023-12-11",185400,185400,184000,185400,174818,218073,183400,1400
"2023-12-12",185500,186400,185000,185600,175006.578125,332590,183920,1400
"2023-12-13",185300,186200,184400,185000,174440.8125,287425,184045,1800
"2023-12-14",187000,187100,184200,184800,174252.234375,760383,184045,2900
"2023-12-15",185800,192800,185200,192800,181795.609375,1228522,184465,7600
"2023-12-18",192800,193000,190000,192000,181041.296875,482331,184885,3000
"2023-12-19",191900,192900,190800,192200,181229.859375,272670,185285,2100
"2023-12-20",192700,199700,192600,199100,187736.046875,961888,186090,7100
"2023-12-21",197500,202000,197100,198700,187358.875,545031,186785,4900
"2023-12-22",2e+05,200500,198500,199000,187641.734375,347866,187535,2000
"2023-12-26",200500,200500,197700,198800,187453.15625,409928,188230,2800
"2023-12-27",198700,199300,197200,198500,187170.28125,331186,188870,2100
"2023-12-28",198800,203500,198400,203500,191884.890625,766503,189805,5100
"2024-01-02",202000,202500,199800,200500,189056.140625,373050,190615,2700
"2024-01-03",199100,199500,193800,193800,182738.546875,548675,191165,5700
"2024-01-04",192000,192800,189100,190000,179155.453125,505979,191585,3700
"2024-01-05",190100,190500,187200,187300,176609.546875,440219,191880,3300
"2024-01-08",187600,188900,185500,185700,175100.859375,323498,192020,3400
"2024-01-09",187800,187800,185500,185600,175006.578125,349068,192170,2300
"2024-01-10",185600,187300,185200,186700,176043.78125,330767,192250,2100
"2024-01-11",187200,189000,187000,187000,176326.671875,538799,192330,2000
"2024-01-12",186600,187400,185800,186000,175383.75,240690,192350,1600
"2024-01-15",186000,187200,185800,187500,176798.125,35456,192475,1400
"2024-01-16",186600,188100,185700,186200,175572.328125,225780,192545,2400
"2024-01-17",186300,186400,181000,181800,171423.46875,481127,191995,5400
"2024-01-18",180000,182500,179900,180200,169914.78125,433597,191405,2600
"2024-01-19",183000,183000,180100,181700,171329.171875,288166,190880,2900
"2024-01-22",182300,182400,179800,180100,169820.5,391914,189930,2600
"2024-01-23",181200,184800,180900,184800,174252.234375,376671,189235,3900
"2024-01-24",185300,185400,182100,185000,174440.8125,345726,188535,3300
"2024-01-25",184400,190500,183500,188700,177929.625,778658,188030,7000
"2024-01-26",189300,189600,186500,187300,176609.546875,468376,187470,3100
"2024-01-29",187300,197300,186600,195600,184435.828125,1199045,187075,10700
"2024-01-30",196000,196600,189300,190000,179155.453125,955999,186550,7300
"2024-01-31",189300,195400,188500,194600,183492.890625,1053355,186590,6900
"2024-02-01",193900,209000,193500,208000,196128.046875,2855056,187490,15500
"2024-02-02",221500,228000,214000,227000,214043.609375,5844398,189475,14000
"2024-02-05",233500,239500,226000,238000,224415.765625,5742710,192090,13500
"2024-02-06",234000,240000,230500,235500,222058.46875,3293825,194585,9500
"2024-02-07",239000,246500,238000,245000,231016.21875,2711612,197500,8500
"2024-02-08",243000,250500,241500,250000,235730.84375,3017429,200650,9000
"2024-02-13",251000,261000,247500,249000,234787.921875,2690468,203800,13500
"2024-02-14",245000,251000,244500,245500,231487.6875,1702299,206700,6500
"2024-02-15",250000,250500,237000,238500,224887.234375,2103428,209315,13500
"2024-02-16",241500,253000,235500,252500,238088.15625,2261790,212850,17500
"2024-02-19",253500,257000,248500,252500,238088.15625,1801441,216465,8500
"2024-02-20",250000,253000,238500,242000,228187.453125,1944653,219480,14500
"2024-02-21",242000,246000,237500,239500,225830.140625,1149137,222450,8500
"2024-02-22",239000,245500,237500,243500,229601.84375,1475580,225385,8000
"2024-02-23",244000,249500,242000,244000,230073.3125,1660625,228335,7500
"2024-02-26",237500,241000,231500,239000,225358.671875,1751340,230850,9500
"2024-02-27",239000,244500,237500,238500,224887.234375,1265434,233410,7000
"2024-02-28",234000,250000,231500,248000,242381.703125,1911431,236030,18500
"2024-02-29",246500,253500,243500,250500,244825.078125,2056620,239055,10000
"2024-03-04",255500,260000,253000,255500,249711.8125,1854280,242100,7000
"2024-03-05",251500,254500,247500,249000,243359.0625,1436614,244150,7000
"2024-03-06",247000,254000,246000,251000,245313.75,1103072,245350,8000
"2024-03-07",252500,258000,247500,250000,244336.40625,988457,245950,10500
"2024-03-08",251500,255000,249500,253000,247268.453125,1210240,246825,5500
"2024-03-11",251000,252500,242000,243500,237983.65625,1178615,246750,10500
"2024-03-12",244000,247000,240000,241500,236028.96875,1096802,246325,7000
"2024-03-13",243500,250000,241000,248500,242870.390625,1413782,246300,9000
"2024-03-14",248000,255000,246000,251500,245802.421875,1574794,246600,9000
"2024-03-15",250000,254500,243500,243500,237983.65625,1175933,246850,11000
"2024-03-18",244000,247500,241000,242500,237006.296875,723835,246350,6500
"2024-03-19",241000,244000,236000,237500,232119.578125,944727,245600,8000
"2024-03-20",240000,246000,237500,241000,235540.296875,1230314,245550,8500
"2024-03-21",247000,254000,246000,252000,246291.09375,1578378,246175,8000
"2024-03-22",252500,254000,241000,243500,237983.65625,1091572,246175,13000
"2024-03-25",244000,245500,239500,239500,234074.28125,784822,245950,6000
"2024-03-26",239000,244000,238500,240500,235051.625,802094,246025,5500
"2024-03-27",241000,247500,240500,244000,238472.34375,818180,246300,7000
"2024-03-28",246000,246000,236000,237000,233545.203125,1050347,245750,10000
"2024-03-29",238000,239000,232000,233000,229603.515625,852346,244875,7000
"2024-04-01",234500,235000,227000,227500,224183.6875,898781,243475,8000
"2024-04-02",225000,226500,216500,220000,216793.03125,1802613,242025,10000
"2024-04-03",219000,223500,214500,216000,212851.34375,1138600,240275,9000
"2024-04-04",218500,228500,216500,226000,222705.5625,1357330,239075,12000
"2024-04-05",223500,230000,223000,225500,222212.859375,1121453,237700,7000
"2024-04-08",227000,238000,226000,232500,229110.8125,1245057,237150,12000
"2024-04-09",234500,236500,228000,228000,224676.40625,663665,236475,8500
"2024-04-11",222000,241000,220000,241000,237486.90625,1853791,236100,21000
"2024-04-12",241000,241500,237000,238000,234530.640625,997710,235425,4500
"2024-04-15",236000,243000,233500,241500,237979.609375,1018783,235325,9500
"2024-04-16",239000,244500,236500,242000,238472.328125,1201766,235300,8000
"2024-04-17",242000,243000,233500,233500,230096.234375,1029202,235100,9500
"2024-04-18",237000,239000,228500,231000,227632.6875,1168222,234600,10500
"2024-04-19",231000,237000,229000,235000,231574.375,1174278,233750,8000
"2024-04-22",240000,246000,239500,245000,241428.609375,1314974,233825,6500
"2024-04-23",250000,251500,246000,249500,245863,1153091,234325,5500
"2024-04-24",249000,253500,247500,252500,248819.265625,1242059,234925,6000
"2024-04-25",251000,254000,246000,250000,246355.71875,1297404,235225,8000
"2024-04-26",250000,253500,243000,249500,245863,980459,235850,10500
"2024-04-29",249000,254500,245500,251500,247833.84375,852780,236775,9000
"2024-04-30",250000,253000,248000,251000,247341.125,545747,237950,5000
"2024-05-02",249000,251500,246500,249000,245370.296875,602350,239400,5000
"2024-05-03",250000,250500,241000,241000,237486.90625,727057,240650,9500
"2024-05-07",242500,246000,240000,242000,238472.328125,799659,241450,6000
"2024-05-08",240500,244000,240000,242000,238472.328125,444082,242275,4000
"2024-05-09",242000,242500,235000,237000,233545.203125,704379,242500,7500
"2024-05-10",239000,243000,237000,241500,237979.609375,455541,243175,6000
"2024-05-13",242500,247500,242000,245000,241428.609375,550255,243375,5500
"2024-05-14",245500,247000,243000,246500,242906.71875,670650,243800,4000
"2024-05-16",248000,248500,245500,247000,243399.4375,559548,244075,3000
"2024-05-17",247000,249500,244000,244000,240443.171875,408947,244175,5500
"2024-05-20",245500,255000,244500,250500,246848.4375,860566,245025,10500
"2024-05-21",249000,254000,248000,253000,249311.984375,576613,246125,6000
"2024-05-22",253000,277500,251000,277000,272962.125,3336634,248225,26500
"2024-05-23",273500,275000,267500,271500,267542.3125,1886248,249550,7500
"2024-05-24",268500,274500,266000,267500,263600.625,1059149,250450,8500
"2024-05-27",267500,271500,262000,265500,261629.78125,1011436,251100,9500
"2024-05-28",265000,270000,263500,265000,261137.046875,598743,251850,6500
"2024-05-29",262500,265000,257000,261000,257195.359375,965532,252425,8000
"2024-05-30",260500,264000,255500,257000,253253.671875,640526,252700,8500
"2024-05-31",259500,260000,253000,253000,249311.984375,1014549,252800,7000
"2024-06-03",257500,270000,257000,265000,261137.046875,1186533,253600,13000
"2024-06-04",262500,265500,258000,259000,255224.515625,660409,254500,7500
"2024-06-05",261000,267500,256500,264000,260151.640625,882084,255600,11000
"2024-06-07",262500,266500,261500,265000,261137.046875,519878,256750,5000
"2024-06-10",261500,271500,261000,267500,263600.625,945927,258275,10500
"2024-06-11",270500,273500,267500,271000,267049.59375,967240,259750,6000
"2024-06-12",273000,273000,268000,270000,266064.1875,567334,261000,5000
"2024-06-13",273000,281000,269000,269000,265078.75,1862106,262125,12000
"2024-06-14",268500,274000,267000,268000,264093.3125,778015,263175,7000
"2024-06-17",276000,285000,275500,278500,274440.25,1945849,264900,9500
"2024-06-18",280500,290000,278500,283000,278874.65625,1667920,266525,11500
"2024-06-19",286500,292500,284000,286500,282323.65625,1228960,268200,8500
"2024-06-20",285500,288000,282500,285500,281338.25,629996,268625,5500
"2024-06-21",283500,285000,279000,280000,275918.40625,876560,269050,6000
"2024-06-24",277000,283000,275500,281000,276903.84375,598019,269725,7500
"2024-06-25",281000,292500,280000,288500,284294.46875,1023261,270875,12500
"2024-06-26",289000,293500,286500,289500,285279.90625,694207,272100,7000
"2024-06-27",287000,298500,286500,298000,295698.84375,1157313,273950,12000
"2024-06-28",299500,299500,293000,295000,292722,761453,275850,6500
"2024-07-01",292000,296000,285500,286000,283791.5,864443,277500,10500
"2024-07-02",283000,283500,271000,272500,270395.75,1558999,277875,12500
"2024-07-03",275000,281500,272500,276000,273868.71875,1072157,278725,9000
"2024-07-04",277500,281000,274500,277500,275357.125,552767,279400,6500
"2024-07-05",277500,282000,277000,281000,278830.125,586121,280200,5000
"2024-07-08",282000,289500,281000,283000,280814.65625,603805,280975,8500
"2024-07-09",284000,285500,272500,274500,272380.3125,1135540,281150,13000
"2024-07-10",275000,277500,272500,274500,272380.3125,672155,281375,5000
"2024-07-11",277000,278500,274500,278500,276349.40625,653458,281850,4000
"2024-07-12",277500,278500,268000,271500,269403.46875,666813,282025,10500
"2024-07-15",273000,273500,267500,268500,266426.625,541442,281525,6000
"2024-07-16",270500,276000,270000,274500,272380.3125,552065,281100,6000
"2024-07-17",275500,275500,268000,268500,266426.625,512968,280200,7500
"2024-07-18",267000,267500,256500,260500,258488.40625,1083373,278950,11000
"2024-07-19",258500,259500,254000,258500,256503.859375,737904,277875,5500
"2024-07-22",259000,261500,251000,255000,253030.890625,769457,276575,10500
"2024-07-23",258000,264500,257500,263500,261465.25,803042,275325,7000
"2024-07-24",259500,263500,257500,258500,256503.859375,608412,273775,6000
"2024-07-25",253000,255000,247500,251500,249557.90625,832753,271450,7500
"2024-07-26",248500,250500,232000,243500,241619.6875,2662741,268875,18500
"2024-07-29",244000,260000,243000,255500,253527.03125,1302271,267350,17000
"2024-07-30",253000,258000,249500,250000,248069.5,594899,266225,8500
"2024-07-31",250000,253500,247500,249000,247077.21875,594919,264875,6000
"2024-08-01",251000,258500,251000,253500,251542.46875,734315,263675,7500
"2024-08-02",242500,248000,242000,244000,242115.828125,889521,261825,6000
"2024-08-05",236000,239500,216500,224000,222270.265625,1465965,258875,23000
"2024-08-06",233500,241500,228000,235000,233185.328125,1250180,256900,13500
"2024-08-07",233000,241000,231500,236000,234177.609375,756779,254975,9500
"2024-08-08",231500,240000,228500,236500,234673.75,698685,252875,11500
"2024-08-09",240500,248000,240000,243000,241123.546875,606967,251450,8000
"2024-08-12",246000,249000,242000,243500,241619.6875,469844,250200,7000
"2024-08-13",242000,245500,240000,243000,241123.546875,358474,248625,5500
"2024-08-14",245500,248000,238500,241000,239139,500276,247250,9500
"2024-08-16",248000,256500,246500,255000,253030.890625,1113073,246975,10000
"2024-08-19",256000,259500,250000,255000,253030.890625,739313,246800,9500
"2024-08-20",258000,261000,255000,256000,254023.15625,660818,246850,6000
"2024-08-21",257500,257500,251000,252500,250550.1875,359513,246300,6500
"2024-08-22",253500,254000,245500,248000,246084.9375,497250,245775,8500
"2024-08-23",245500,254000,245000,252500,250550.1875,449189,245825,9000
"2024-08-26",255500,258000,247500,249500,247573.359375,469538,246125,10500
"2024-08-27",248500,251000,244500,247500,245588.796875,555018,245725,6500
"2024-08-28",249500,261000,246000,259000,257000,1170970,246175,15000
"2024-08-29",261500,267000,256000,258500,256503.859375,1646679,246650,11000
"2024-08-30",261000,265500,255500,255500,253527.03125,1206940,246750,10000
"2024-09-02",256000,256000,245000,246000,244100.390625,1006660,246850,11000
"2024-09-03",244000,244500,236000,237500,235666.015625,1024521,247525,8500
"2024-09-04",231000,236500,229500,232500,230704.625,942257,247400,7000
"2024-09-05",236000,237500,227000,229000,227231.65625,884047,247050,10500
"2024-09-06",228000,230500,223000,227500,225743.234375,710077,246600,7500
"2024-09-09",225500,231500,225000,229500,227727.796875,638085,245925,6500
"2024-09-10",229500,231000,227000,231000,229216.21875,364974,245300,4000
"2024-09-11",229500,230500,221500,223500,221774.125,781938,244325,9000
"2024-09-12",226000,232000,225500,232000,230208.484375,660069,243875,6500
"2024-09-13",237500,240500,234500,237000,235169.875,524969,242975,6000
"2024-09-19",244000,246500,241500,246000,244100.390625,848380,242525,5000
"2024-09-20",250000,251000,247500,250500,248565.640625,809348,242250,3500
"2024-09-23",251500,251500,246500,249000,247077.21875,484728,242075,5000
"2024-09-24",249000,253000,248000,253000,251046.328125,429463,242325,5000
"2024-09-25",255500,257000,250500,251500,249557.90625,575575,242275,6500
"2024-09-26",250000,259000,247500,259000,257000,766978,242750,11500
"2024-09-27",257500,259000,253500,254500,254500,493853,243100,5500
"2024-09-30",255500,256000,244000,244000,244000,1032595,242350,12000
"2024-10-02",237500,241000,236500,237000,237000,1035510,241275,4500
"2024-10-04",235500,241500,232000,239500,239500,856583,240475,9500
"2024-10-07",244000,247000,241000,247000,247000,731171,240525,6000
"2024-10-08",244500,247000,244000,246000,246000,413552,240950,3000
"2024-10-10",253000,255500,246000,246000,246000,641891,241625,9500
"2024-10-11",248000,249500,246500,248500,248500,282919,242600,3000
"2024-10-14",250500,254000,248000,248500,248500,307668,243650,6000
"2024-10-15",249500,249500,246000,246000,246000,382087,244475,3500
"2024-10-16",246000,247000,242000,247000,247000,799813,245275,5000
"2024-10-17",245000,246000,235500,235500,235500,923060,245875,10500
"2024-10-18",237000,239000,233000,234500,234500,696368,246000,6000
"2024-10-21",235000,240000,234500,237000,237000,443742,246000,5500
"2024-10-22",236000,239000,232500,234500,234500,517834,245425,6500
"2024-10-23",236500,243000,234000,241000,241000,671384,244950,9000
"2024-10-24",241000,241000,228000,228500,228500,1209781,243925,13000
"2024-10-25",226500,231000,220500,225500,225500,1116832,242550,10500
"2024-10-28",226000,229000,224000,226500,226500,639039,241300,5000
"2024-10-29",226000,226500,221000,224000,224000,746178,239550,5500
"2024-10-30",223000,225000,220500,220500,220500,554300,237850,4500
"2024-10-31",220500,221500,215000,215000,215000,1075398,236400,6500
"2024-11-01",212500,216500,211500,213500,213500,803780,235225,5000
